je - ja - I
son - jego - his
que - że - that
il - on - he
était - był - was
pour - dla - for
sur - na - on
sont - są - are
avec - z, ze (kimś, czymś) - with
ils - oni - they
être - być - be
à - do (kierunek), w, na - at
un - jeden - one
avoir - mieć - have
ce - to - this
à partir de - od - from
par - przez - by
chaud - gorący - hot
mot - słowo - word
mais - ale - but
que - co - what
certains - niektóre - some
est - jest - is
il - to - it
vous - ty - you
ou - lub - or
eu - miał - had
la - kilka - the
de - stopa - of
à - do - to
et - i - and
un - ciągnąć - a
dans - w - in
nous - my - we
boîte - puszka - can
dehors - na zewnątrz - out
autre - inny - other
étaient - były - were
qui - który - which
faire - zrobić - do
leur - ich - their
temps - czas - time
si - jeśli - if
volonté - wola, chęć - will
comment - jak - how
dit - powiedział - said
un - próba - an
chaque - każda - each
dire - powiedzieć - tell
ne - nie - does
ensemble - zestaw - set
trois - trzy - three
vouloir - chcą - want
air - powietrze - air
bien - dobrze - well
aussi - również - also
jouer - grać - play
petit - mały - small
fin - koniec - end
mettre - kłaść, postawić, zakładać, wkładać - put
maison - dom - home
lire - czytać - read
main - ręka - hand
port - port - port
grand - duży - large
épeler - literować - spell
ajouter - dodać, dołączyć - add
ici - tutaj - here
il faut - trzeba, należy - must
grand - duży - big
haut - wysoki - high
tel - taki - such
suivre - śledzić - follow
acte - akt, uczynek - act
pourquoi - dlaczego - why
interroger - zapytać - ask
hommes - mężczyźni - men
changement - zmiana - change
est allé - poszedł - went
lumière - światła - light
genre - rodzaj - kind
de - od, z - off
besoin - potrzeba, konieczność - need
maison - dom - house
image - obraz - picture
essayer - spróbuj - try
nous - nas - us
encore - jeszcze, wciąż, znowu - again
animal - zwierzę - animal
point - punkt - point
mère - matka - mother
monde - świat - world
près de - blisko - near
construire - budować - build
soi - własny - self
terre - ziemia, gleba - land, earth
père - ojciec - father
tout - cały, całość, wszystko - any
nouveau - nowy - new
travail - praca - work
partie - część - part
prendre - wziąć - take
obtenir - dostać - get
lieu - miejsce - place
fabriqué - wyprodukowany, zrobiony - made
vivre - żyć - live
où - gdzie - where
après - później - after
arrière - z powrotem - back
peu - mało - little
seulement - tylko - only
tour - okrągły - round
homme - mężczyzna - man
année - rok - year
est venu - spokojnie - came
montrer - pokaż - show
tous - każdy - every
bon - dobry - good
moi - mnie - me
donner - dać - give
notre - nasze - our
sous - pod - under
nom - Nazwa - name
très - bardzo - very
par - przez - through
juste - tylko - just
forme - formularz - form
phrase - zdanie - sentence
grand - wielki - great
penser - myśleć - think
dire - powiedzieć - say
aider - pomóc - help
faible - niski - low
ligne - linia - line
différer - różnić się - differ
tour - kolej - turn
la cause - przyczyna - cause
beaucoup - wiele - much
signifier - znaczyć - mean
avant - przed - before
déménagement - przeprowadzka - move
droit - prawy, uczyciwy, prosty - right
garçon - chłopiec - boy
vieux - stary - old
trop - zbyt - too
même - taki sam, nawet - even, same
elle - ona - she
tous - wszystko - all
là - tam - there
quand - kiedy - when
jusqu’à - (aż) do - until, up to
utiliser - użyć, wykorzystać - use
votre - pana/pani/państwa, wasz - your
manière - sposób - way
sur - o (czymś), na (powierzchni) - about
beaucoup - wiele - many
puis - następnie - then
les - im - them
écrire - pisać - write
voudrais - byłoby - would
comme - jak - as, like
si - gdyby, jeśli - if, whether
ces - te - these
sa - jej - her
long - długi - long
faire - robić, zrobić - make
chose - rzecz - thing
voir - widzieć - see
lui - mu - him
deux - dwa - two
a - ma - has
regarder - szukać - look
jour - dzień - day
aller - iść - go
venir - przyjść - come
nombre - liczba - number
son - brzmieć - sound
aucun - nie - no
plus - więcej, najbardziej, dodać - more, most
personnes - ludzie - people
ma - mój - my
sur - ponad - over
savoir - wiedzieć - know
eau - woda - water
que - niż - than
appel - wezwanie - call
première - pierwszy - first
qui - kto - who
pouvoir - móc, być w stanie - can, may, might
vers le bas - w dół - down
côté - bok - side
maintenant - teraz - now
trouver - odnaleźć - find
tête - głowa - head
supporter - stać - stand
propre - własny - own
page - kartka, strona - page
devoir - musieć, zawdzięczać - must, shall
pays - kraj - country
trouvé - znaleziony - found
réponse - odpowiedź - answer
école - szkoła - school
croître - rosnąć - grow
étude - nauka, studia - study
encore - jeszcze - still
apprendre - uczyć się - learn
usine - fabryka - factory
couvercle - osłona, pokrywa - cover
nourriture - jedzenie, żywność - food
soleil - słońce - sun
quatre - cztery - four
entre - między - between
état - stan - state
garder - zachować - keep
œil - oko - eye
jamais - nigdy - never
dernier - ostatnia - last
laisser - pozwolić, zostawić - let
pensée - myśl - thought
ville - miasto - city
arbre - drzewo - tree
traverser - przekroczyć, przejść - cross
ferme - gospodarstwo - farm
dur - trudne - hard
début - początek - start
puissance - moc - might
histoire - historia - story, history
scie - piła - saw
loin - daleko - far
mer - morze - sea
tirer - rysować - draw
gauche - lewy - left
tard - późno - late
courir - biegać - run
non - nie - no, not
tandis que - podczas - while
presse - prasa - press
proche - bliski - close
nuit - noc - night
réel - prawdziwy - real
vie - życie - life
peu - kilka - few
nord - północ - north
livre - książka - book
porter - nieść - carry
a pris - wziął - took
science - nauka - science
manger - jeść - eat
chambre - pokój - room
ami - przyjaciel - friend
a commencé - rozpoczął - began
idée - pomysł - idea
poisson - ryba - fish
montagne - góra - mountain
Arrêtez - zatrzymać - stop
une fois - raz - once
base - podstawa - base
entendre - słyszeć - hear
cheval - koń - horse
coupe - cięcie - cut
sûr - pewny - sure
regarder - oglądać - watch
couleur - kolor - color
face - twarz - face
bois - drewna - wood
principal - główny - main
ouvert - otwarte - open
paraître - wydają - seem
ensemble - razem - together
suivant - następna - next
blanc - biały - white
enfants - dzieci - children
commencer - zacząć - begin
eu - got - got
marcher - chodzić - walk
exemple - przykład - example
facilité - łatwość, zdolność - ease
papier - papier - paper
groupe - grupa - group
toujours - zawsze - always
musique - muzyka - music
ceux - te, ci - those
tous les deux - oba, oboje - both
marque - znak, ślad - mark
souvent - często - often
lettre - list - letter
jusqu’à ce que - do, dopóki - until
mile - mila - mile
rivière - rzeka - river
voiture - samochód - car
pieds - stopy - feet
soins - opieka - care
deuxième - drugi - second
assez - wystarczy - enough
plaine - nizina, równina - plain
fille - dziewczyna - girl
habituel - zwykły - usual
jeune - młody - young
prêt - gotowy - ready
au-dessus - powyżej - above
jamais - kiedykolwiek - ever
rouge - czerwony - red
liste - lista - list
bien que - chociaż - though
sentir - czuć - feel
parler - dyskusja - talk
oiseau - ptak - bird
bientôt - wkrótce - soon
corps - ciało - body
chien - pies - dog
famille - rodzina - family
direct - bezpośredni - direct
pose - poza, postawa - pose
laisser - zostawić - leave
chanson - piosenka - song
mesurer - pomiaru - measure
porte - drzwi - door
produit - Produkt - product
noir - czarny - black
court - krótki - short
chiffre - liczebnik - numeral
classe - Klasa - class
vent - wiatr - wind
question - pytanie - question
arriver - stanie - happen
complète - pełna - complete
navire - statek - ship
zone - obszar - area
moitié - połowa - half
rock - skalny - rock
ordre - zamówienie - order
feu - ogień - fire
sud - południe - south
problème - problem - problem
pièce - sztuk - piece
dit - powiedział - told
savait - wiedział - knew
passer - przekazać - pass
depuis - od - since
haut - góry - top
ensemble - cały - whole
roi - król - king
rue - ulica - street
pouce - cal - inch
multiplier - mnożenie - multiply
rien - nic - nothing
cours - Oczywiście - course
rester - pobyt - stay
roue - koło - wheel
plein - pełna - full
force - siła - force
bleu - niebieski - blue
objet - obiekt - object
décider - zdecydować - decide
surface - powierzchnia - surface
profond - głęboko - deep
lune - księżyc - moon
île - wyspa - island
pied - stopa - foot
système - System - system
occupé - zajęty - busy
test - próba - test
record - rekord - record
bateau - łódź - boat
commun - wspólny - common
or - złota - gold
possible - możliwe - possible
plan - samolot - plane
place - siona - stead
sec - suche - dry
se demander - zastanawiać się - wonder
rire - śmiech - laugh
mille - tysiąc - thousand
il ya - temu - ago
ran - Ran - ran
vérifier - sprawdź - check
jeu - gra - game
forme - kształt - shape
assimiler - zrównać - equate
chaud - gorący - hot
manquer - panna - miss
apporté - wniesiona - brought
chaleur - ciepło - heat
neige - śnieg - snow
pneu - opon - tire
apporter - przynieść - bring
oui - tak - yes
lointain - odległy - distant
remplir - napełniać - fill
est - wschód - east
peindre - malować - paint
langue - język - language
entre - między - among
unité - jednostka - unit
puissance - moc - power
ville - miasto - town
fin - dobrze - fine
certain - pewny - certain
voler - latać - fly
tomber - spadek - fall
conduire - prowadzić - lead
cri - krzyk - cry
sombre - ciemny - dark
machine - maszyna - machine
Note - uwaga - note
patienter - czekać - wait
plan - planie - plan
figure - rysunek - figure
étoile - gwiazda - star
boîte - Skrzynka - box
nom - rzeczownik - noun
domaine - pole - field
reste - reszta - rest
correct - poprawny - correct
capable - zdolny - able
livre - funt - pound
Terminé - gotowe - done
beauté - urody - beauty
entraînement - napęd - drive
résisté - stał - stood
contenir - zawierają - contain
avant - z przodu - front
enseigner - uczyć - teach
semaine - tydzień - week
finale - ostateczna - final
donné - dał - gave
vert - zielony - green
oh - oh - oh
rapide - szybki - quick
développer - rozwijać - develop
océan - ocean - ocean
chaud - ciepły - warm
gratuit - za darmo - free
minute - minut - minute
fort - silny - strong
spécial - Specjalne - special
esprit - umysł - mind
derrière - za - behind
clair - jasne - clear
queue - ogon - tail
produire - produkować - produce
fait - fakt - fact
espace - przestrzeń - space
entendu - słyszałem - heard
meilleur - najlepszy - best
heure - godzina - hour
mieux - lepiej - better
vrai - prawdziwy - true
pendant - podczas - during
cent - sto - hundred
cinq - pięć - five
rappeler - pamiętaj - remember
étape - krok - step
tôt - wcześnie - early
tenir - przytrzymaj - hold
ouest - zachód - west
sol - ziemia - ground
intérêt - odsetki - interest
atteindre - dotrzeć - reach
rapide - szybko - fast
verbe - czasownik - verb
chanter - śpiewać - sing
écouter - słuchać - listen
six - sześć - six
table - stół - table
Voyage - podróży - travel
moins - mniej - less
matin - rano - morning
dix - dziesięć - ten
simple - proste - simple
plusieurs - kilka - several
voyelle - samogłoska - vowel
vers - kierunku - toward
guerre - wojna - war
poser - świeckich - lay
contre - przed - against
modèle - wzór - pattern
lent - powolny - slow
centre - centrum - center
amour - miłość - love
personne - osoba - person
argent - pieniądze - money
servir - służyć - serve
apparaître - pojawiać się - appear
route - drogowego - road
carte - Mapa - map
pluie - deszcz - rain
règle - reguła - rule
gouverner - rządzić - govern
tirer - ciągnąć - pull
froid - zimno - cold
avis - ogłoszenie - notice
voix - głos - voice
énergie - energii - energy
chasse - polowanie - hunt
probable - prawdopodobne - probable
lit - łóżko - bed
frère - brat - brother
œuf - jajko - egg
tour - jazda - ride
cellule - komórek - cell
croire - wierzyć - believe
peut-être - być może - perhaps
choisir - wybrać - pick
soudain - nagły - sudden
compter - liczyć - count
carré - plac - square
raison - powodem - reason
longueur - długość - length
représenter - stanowią - represent
art - sztuka - art
sujet - Temat - subject
région - Region - region
taille - rozmiar - size
varier - różnią - vary
régler - osiedlenie - settle
parler - mówić - speak
poids - waga - weight
général - ogólnie - general
glace - lód - ice
question - względu na to, - matter
cercle - krąg - circle
paire - para - pair
inclure - zawierać - include
fracture - podzielić - divide
syllabe - sylaby - syllable
feutre - filc - felt
grandiose - wielki - grand
balle - piłka - ball
encore - jeszcze - yet
vague - fala - wave
tomber - upuścić - drop
cœur - serce - heart
présent - Niniejszy - present
lourd - ciężki - heavy
danse - taniec - dance
moteur - silnik - engine
position - stanowisko - position
bras - ramię - arm
large - szeroki - wide
voile - żagiel - sail
matériel - materiał - material
fraction - frakcja - fraction
forêt - las - forest
s’asseoir - siedzieć - sit
course - wyścig - race
fenêtre - okno - window
magasin - sklep - store
été - lato - summer
train - pociąg - train
sommeil - sen - sleep
prouver - dowieść - prove
seul - samotny - lone
jambe - mecz - leg
exercice - ćwiczenie - exercise
mur - ściana - wall
capture - catch - catch
monture - mocowanie - mount
souhaiter - chcieć - wish
ciel - niebo - sky
conseil - wyżywienie - board
joie - radość - joy
hiver - zima - winter
sat - nasyconym - sat
écrit - napisane - written
sauvage - dziki - wild
instrument - instrument - instrument
conservé - utrzymane - kept
verre - szkła - glass
herbe - trawka - grass
vache - krowa - cow
emploi - praca - job
bord - krawędź - edge
signe - znak - sign
visite - wizyta - visit
passé - przeszłość - past
doux - miękkie - soft
amusement - zabawy - fun
clair - jasny - bright
gaz - gaz - gas
temps - pogoda - weather
mois - miesiąc - month
million - milion - million
porter - niedźwiedź - bear
finition - wykończenie - finish
heureux - szczęśliwy - happy
espoir - nadzieję - hope
fleur - kwiat - flower
vêtir - odziać - clothe
étrange - dziwny - strange
disparu - Odszedł - gone
commerce - handel - trade
mélodie - melodia - melody
voyage - wycieczka - trip
bureau - biuro - office
recevoir - otrzymać - receive
rangée - wiersz - row
bouche - usta - mouth
exact - dokładny - exact
symbole - symbol - symbol
mourir - śmierć - die
moins - najmniej - least
difficulté - kłopot - trouble
cri - krzyk - shout
sauf - z wyjątkiem - except
écrit - napisał - wrote
semence - nasion - seed
ton - ton - tone
joindre - dołączyć - join
suggérer - sugerują, - suggest
propre - czyste - clean
pause - przerwa - break
dame - pani - lady
cour - stoczni - yard
augmenter - wzrosnąć - rise
mauvais - zły - bad
coup - cios - blow
huile - olej - oil
sang - krwi - blood
toucher - dotknąć - touch
a augmenté - wzrosła - grew
cent - centów - cent
mélanger - mix - mix
équipe - zespół - team
fil - drut - wire
coût - koszt - cost
perdu - stracony - lost
brun - brązowy - brown
porter - nosić - wear
jardin - ogród - garden
égal - równy - equal
expédié - wysłany - sent
choisir - wybrać - choose
est tombé - spadła - fell
s’adapter - pasować - fit
débit - płynąć - flow
juste - sprawiedliwy - fair
banque - Bank - bank
recueillir - zbierać - collect
sauver - oszczędzać - save
contrôle - kontrola - control
décimal - dziesiętny - decimal
oreille - ucho - ear
autre - więcej - else
tout à fait - całkiem - quite
cassé - złamał - broke
cas - sprawa - case
milieu - średniej - middle
tuer - zabić - kill
fils - syn - son
lac - jezioro - lake
moment - chwilę - moment
échelle - skala - scale
fort - głośno - loud
printemps - wiosna - spring
observer - obserwować - observe
enfant - dziecko - child
droit - prosto - straight
consonne - spółgłoska - consonant
nation - naród - nation
dictionnaire - Słownik - dictionary
lait - mleko - milk
vitesse - prędkość - speed
méthode - metoda - method
organe - narząd - organ
payer - płacić - pay
âge - wiek - age
section - sekcja - section
robe - sukienka - dress
nuage - chmura - cloud
surprise - niespodzianka - surprise
calme - cichy - quiet
pierre - kamień - stone
minuscule - małe - tiny
montée - wznoszenia - climb
frais - chłodny - cool
conception - projekt - design
pauvres - słaba - poor
lot - wiele - lot
expérience - eksperyment - experiment
bas - dolny - bottom
clé - klucz - key
fer - żelaza - iron
unique - pojedynczy - single
bâton - kij - stick
plat - mieszkanie - flat
vingt - dwadzieścia - twenty
peau - skóra - skin
sourire - uśmiech - smile
pli - marszczyć - crease
trou - otwór - hole
sauter - skok - jump
bébé - dziecko - baby
huit - osiem - eight
village - wieś - village
se rencontrent - spotkać - meet
racine - korzeń - root
acheter - kupić - buy
augmenter - podnieść - raise
résoudre - rozwiązania - solve
métal - metalu - metal
si - czy - whether
pousser - pchnięcie - push
sept - siedem - seven
paragraphe - pkt - paragraph
troisième - trzeci - third
doit - powinien - shall
en attente - held - held
cheveux - włosy - hair
décrire - opisania - describe
cuisinier - kucharz - cook
étage - piętro - floor
chaque - albo - either
résultat - wynik - result
brûler - palić - burn
colline - wzgórzu - hill
coffre-fort - bezpieczne - safe
chat - kot - cat
siècle - wiek - century
envisager - rozważać - consider
type - Typ - type
droit - prawo - law
peu - kawałek - bit
côte - Wybrzeże - coast
copie - kopia - copy
phrase - Zwrot - phrase
silencieux - cichy - silent
haut - wysoki - tall
sable - piasek - sand
sol - gleby - soil
rouleau - rolki - roll
température - temperatura - temperature
doigt - palec - finger
industrie - przemysł - industry
valeur - wartość - value
lutte - walka - fight
mensonge - kłamstwo - lie
battre - pokonać - beat
exciter - podniecać - excite
naturel - naturalne - natural
vue - widok - view
sens - poczucie - sense
capital - kapitał - capital
ne sera pas - nie będzie - won’t
chaise - krzesło - chair
danger - niebezpieczeństwo - danger
fruit - owoc - fruit
riche - bogaty - rich
épais - gruby - thick
soldat - żołnierz - soldier
processus - proces - process
fonctionner - pracować - operate
pratique - praktyka - practice
séparé - oddzielne - separate
difficile - trudne - difficult
médecin - lekarz - doctor
s’il vous plaît - proszę - please
protéger - ochrony - protect
midi - południe - noon
récolte - upraw - crop
moderne - nowoczesny - modern
élément - elementu - element
frapper - uderzać - hit
étudiant - uczeń - student
coin - narożnik - corner
partie - strona - party
alimentation - Zasilanie - supply
dont - którego - whose
localiser - lokalizować - locate
anneau - pierścień - ring
caractère - znaków - character
insecte - owad - insect
pris - złapany - caught
période - okres - period
indiquer - wskazują, - indicate
radio - Radio - radio
rayon - zabrał - spoke
atome - atom - atom
humain - ludzki - human
effet - efekt - effect
électrique - elektryczny - electric
attendre - oczekiwać - expect
os - kości - bone
rail - szyna - rail
imaginer - wyobrazić - imagine
fournir - zapewniać - provide
se mettre d’accord - zgadzać się - agree
ainsi - tak więc - thus
doux - łagodny - gentle
femme - kobieta - woman
capitaine - kapitan - captain
deviner - odgadnąć - guess
nécessaire - konieczne - necessary
net - ostry - sharp
aile - skrzydło - wing
créer - stworzenia - create
voisin - sąsiad - neighbor
lavage - myjnia - wash
chauve-souris - nietoperz - bat
plutôt - raczej - rather
foule - tłum - crowd
blé - kukurydza - corn
comparer - porównanie - compare
poème - poemat - poem
chaîne - sznur - string
cloche - dzwon - bell
dépendre - zależy - depend
viande - mięso - meat
rub - trzeć - rub
tube - rurka - tube
célèbre - słynny - famous
dollar - dolar - dollar
courant - strumień - stream
peur - strach - fear
vue - widok - sight
mince - cienki - thin
triangle - trójkąt - triangle
planète - planeta - planet
se dépêcher - pospiesz - hurry
chef - szef - chief
colonie - kolonia - colony
horloge - Zegary - clock
mine - kopalnia - mine
lien - krawat - tie
entrer - wejść - enter
majeur - głównym - major
frais - świeży - fresh
recherche - szukaj - search
envoyer - wyślij - send
jaune - żółty - yellow
pistolet - pistolet - gun
permettre - dopuszczać - allow
impression - drukuj - print
mort - martwy - dead
place - miejsce - spot
désert - pustynia - desert
costume - garnitur - suit
courant - aktualny - current
ascenseur - wyciąg - lift
rose - róża - rose
arriver - przyjazd - arrive
maître - mistrz - master
piste - tor - track
mère - rodzic - parent
rivage - brzeg - shore
division - podział - division
feuille - arkusz - sheet
substance - substancja - substance
favoriser - faworyzować - favor
relier - podłącz - connect
poste - po - post
passer - wydać - spend
corde - akord - chord
graisse - tłuszcz - fat
heureux - zadowolony - glad
original - oryginalny - original
part - akcji - share
station - Stacja - station
papa - tata - dad
pain - chleb - bread
charger - naładować - charge
propre - właściwy - proper
bar - bar - bar
proposition - oferta - offer
segment - Segment - segment
esclave - niewolnik - slave
canard - kaczka - duck
instant - błyskawicznej - instant
marché - rynku - market
degré - stopień - degree
peupler - wypełnić - populate
poussin - pisklę - chick
cher - drogi - dear
ennemi - wróg - enemy
répondre - odpowiedz - reply
boisson - pić - drink
se produire - występują - occur
support - wsparcie - support
discours - mowy - speech
nature - natura - nature
gamme - zakres - range
vapeur - parowy - steam
mouvement - ruch - motion
chemin - ścieżka - path
liquide - ciecz - liquid
enregistrer - zaloguj - log
signifiait - oznaczało - meant
quotient - iloraz - quotient
dents - zęby - teeth
coquille - powłoki - shell
cou - szyi - neck
oxygène - tlenu - oxygen
sucre - cukier - sugar
décès - śmierć - death
assez - dość - pretty
compétence - umiejętność - skill
femmes - kobiety - women
saison - sezon - season
solution - rozwiązanie - solution
aimant - magnes - magnet
argent - srebrny - silver
merci - dziękuję - thank
branche - gałęzi - branch
rencontre - mecz - match
suffixe - przyrostek - suffix
particulièrement - szczególnie - especially
figue - figa - fig
peur - boi - afraid
énorme - ogromny - huge
sœur - siostra - sister
acier - stal - steel
discuter - omówić - discuss
avant - do przodu - forward
similaire - podobne - similar
guider - przewodnik - guide
expérience - doświadczenie - experience
score - wynik - score
pomme - jabłko - apple
acheté - kupiony - bought
LED - doprowadziło - led
pas - boisko - pitch
manteau - płaszcz - coat
masse - masa - mass
carte - karta - card
bande - zespół - band
corde - lina - rope
glissement - poślizgu - slip
gagner - zwycięstwo - win
rêver - śnić - dream
soirée - wieczorem - evening
condition - Stan - condition
alimentation - RSS - feed
outil - narzędzie - tool
total - całkowity - total
de base - podstawowy - basic
odeur - zapach - smell
vallée - dolina - valley
ni - ani - nor
double - podwójne - double
siège - siedziba - seat
continuer - dalej - continue
bloc - blok - block
graphique - wykres - chart
chapeau - kapelusz - hat
vendre - sprzedać - sell
succès - sukces - success
entreprise - firma - company
soustraire - odejmowanie - subtract
événement - wydarzenie - event
particulier - szczególności - particular
accord - sprawa - deal
baignade - pływać - swim
terme - termin - term
opposé - naprzeciwko - opposite
femme - żona - wife
chaussure - buty - shoe
épaule - ramię - shoulder
propagation - spread - spread
organiser - zorganizować - arrange
camp - obóz - camp
inventer - wymyślać - invent
coton - bawełna - cotton
né - Urodzony - born
déterminer - określenia - determine
litre - kwarta - quart
neuf - dziewięć - nine
camion - ciężarówka - truck
bruit - hałas - noise
niveau - poziom - level
chance - szansa - chance
recueillir - zbierać - gather
boutique - Sklep - shop
tronçon - odcinek - stretch
jeter - rzucać - throw
éclat - połysk - shine
propriété - właściwość - property
colonne - kolumna - column
molécule - cząsteczka - molecule
sélectionner - wybierać - select
mal - nie tak - wrong
gris - szary - gray
répétition - powtórz - repeat
exiger - wymagać - require
large - szeroki - broad
préparer - przygotować - prepare
sel - sól - salt
nez - nos - nose
pluriel - liczba mnoga - plural
colère - złość - anger
revendication - oświadczenie - claim
continent - kontynent - continent
quelque chose - coś - something
aujourd'hui - dzisiaj - today
demain - jutro - tomorrow
Pardon! - Przepraszam! - Excuse me!/Sorry!
excuse - przeprosiny, wymówka - excuse
faute - wina - fault
hier - wczoraj - yesterday
combien - ile - how many
attention - uwaga - attention
merveilleux - wspaniały, rewelacyjny, świetny - wonderful
Christ - Chrystus - Christ
comprendre - rozumieć - understand
petit déjeuner - śniadanie - breakfast
déjeuner - obiad - lunch
souper - kolacja - supper
Tais-toi! - Milcz! - Shut up!
connard - drań - bastard
salle de bains - łazienka, kąpiel - bathroom
toilette - toaleta - toilet
traduction - tłumaczenie - translation
sécurité - bezpieczeństwo - security
Noël - Boże Narodzenie - Christmas
Pâques - Wielkanoc - Easter
bonne nuit - dobranoc! - good night
fermé - zamknięty - closed
ce soir - tej nocy, dziś wieczorem - tonight
café - kawa - coffee
silence - cisza, spokój - silence
au revoir - do widzenia - goodbye
accident - wypadek - accident