io - ja - I
il suo - jego/Pański - his
per - dla, z powodu, za (ileś), na (osobę) - for
su - na, po (powierzchni), na górze - on
sono - jestem - are
con - z, ze (kimś/czymś) - with
essi/esse - oni/one - they
essere - być - be
uno - jeden - one
avere - mieć - have
questo - ten, to - this
parola - słowo, mowa - word
ma - ale - but
è - jest - is
esso - to - it
voi - wy - you
di - z, ze (np. zrobiony z), autorstwa, o (czymś) - of
a - do, na (kierunek), w, we, na, o (termin) - at, to
e - i, a - and
in - do, na (kierunek), w, we - in
lattina - puszka - can
fuori - na dworze, na zewnątrz - out
fare - robić, zrobić, stać się - do
volontà - wola - will
suddetto - powyższy, wyżej wymieniony - aforesaid
set - komplet - set
tre - trzy - three
desiderare - pragnąć, pożądać - want
aria - powietrze - air
bene - dobrze, słusznie, dobro - well
giocare - bawić się, grać - play
mettere - położyć, ułożyć, wsadzić - put
leggere - czytać - read
mano - ręka - hand
porto - port - port
compitare - literować - spell
aggiungere - dodać, dołączyć - add
anche - także, również, nawet - also, even
qui - tutaj - here
tale - taki - such
seguire - podążać, śledzić, posłuchać - follow
atto - akt, czyn, uczynek - act
perché - dlaczego, ponieważ, żeby - why, because
chiedere - zapytać, poprosić - ask
maschi - mężczyzna, samiec - men
cambiamento - zmiana, przesiadka - change
luce - światło - light
spento - wyłączony, zgaszony - off
bisogno - potrzeba - need
casa - dom - house, home
immagine - obraz, zdjęcie - picture
provare - wypróbować - try
noi - my, nas - we, us
di nuovo - znowu - again
animale - zwierzę - animal
punto - punkt, kropka - point
madre - matka - mother
mondo - świat - world
vicino - bliski, sąsiedni - near
costruire - budować - build
padre - ojciec, ksiądz - father
qualsiasi - którykolwiek, jakikolwiek - any, whatever
nuovo - nowy - new
parte - element, część, składnik - part
ottenere - zyskać, uzyskać - get
posto - miejsce - place
vivere - żyć, przeżyć, doświadczyć - live
dove - dokąd, gdzie - where
dopo - po, potem, następnie - after
indietro - do tyłu, z powrotem, w tyle - back
poco - mało - little
uomo - człowiek, mężczyzna - man
anno - rok - year
è venuto in mente - przyszło mi do głowy - came to mind
spettacolo - przedstawienie, widowisko - show
ogni - każdy - every, each
buono - dobry, grzeczny, uprzejmy - good
me - mnie, mi - me
dare - dać - give
il nostro - nasz/nasza - our
sotto - na dole, poniżej, pod - under
nome - imię, nazwa - name
attraverso - przez, w poprzek - through
solo - sam, samotny, dopiero, tylko - only, just
frase - zdanie - sentence
pensare - myśleć, wymyślić - think
aiutare - pomóc - help
basso - niski - low
linea - linia, przewód - line
differire - odłożyć (na później) - differ
turno - zmiana, runda - turn, round
causa - przyczyna - cause
molto - dużo, wiele, bardzo, bardzo dużo - much, very
dire - powiedzieć, mówić - to say, mean, tell
prima - najpierw, wcześniej, dawniej - before
spostare - przesunąć, przenieść - move
diritto - prawo, uprawnienie - right
ragazzo - chłopak - boy
vecchio - stary, staruszek - old
troppo - zbyt, za (np. ciężki), za dużo - too
stesso - taki sam - same
ci - nam, nas - us
quando - gdy, kiedy - when
su - na, nad, na górze - up
uso - użycie, użytek - use
il tuo - twój - your
modo - sposób - way
circa - około, w przybliżeniu - about
molti - dużo, wiele - many
allora - więc, wtedy, wówczas - then
loro - oni, one, ich - them, their
scrivere - pisać, napisać - write
sarebbe - byłoby - would be
come - jak, jako, taki jak - as, like, how
così - tak, w ten sposób - so
queste - te - these
lei - ona, ją - she, her
lungo - długo - long
rendere - uczynić, przynieść - make
cosa? - co? - what?
cosa - rzecz - thing
vedere - widzieć - see
lui - on, jego - he, him
due - dwa - two
guardare - oglądać, patrzeć, spojrzeć, pilnować - look
di più - więcej - more
giorno - dzień, doba - day
potuto - mógłby - could
andare - chodzić, iść - go
venire - przybyć, dotrzeć, pochodzić (skądś) - come
numero - liczba - number
suono - dźwięk - sound
no - nie - no
il più - najwięcej - most
persone - ludzie - people
il mio - mój/moja - my
oltre - za, dalej - over
sapere - wiedzieć - know
acqua - woda - water
di - niż (porównanie) - than
chiamata - rozmowa telefoniczna, wezwanie - call
primo - pierwszy, początkowy, wczesny - first
che - co, coś, który - that, which, who
potere - móc, potrafić - be able
giù - na dole, na dół - down
lato - bok, strona - side
trovare - znaleźć - find
testa - głowa - head
stare in piedi - stać - stand
proprio - własny - own
pagina - strona - page
dove̲re - musieć, być winnym, obowiązek - must, duty
paese - kraj - country
fondare - założyć, ufundować - found
risposta - odpowiedź - answer
scuola - szkoła - school
crescere - rosnąć, wyrosnąć - grow
studio - nauka, studia - study
ancora - jeszcze - still
imparare - uczyć się - learn
impianto - urządzenie, instalacja - system, installation
pianta - roślina -  plant
copertura - pokrycie, obudowa, osłona - cover
cibo - jedzenie - food
sole - słońce - sun
quattro - cztery - four
fra - między, za (czas, np. za godzinę) - between
stato - stan (czegoś), państwo - state
mantenere - utrzymać, utrzymywać, zachować - keep
occhio - oko - eye
ultimo - ostatni, najnowszy - last
pensiero - myśl - thought
albero - drzewo - tree
attraversare - przemierzać, przekroczyć - cross
fattoria - farma, gospodarstwo - farm
inizio - początek - start
forza - siła - might
sega - piła - saw
mare - morze - sea
disegnare - rysować - draw
sinistr - lewy (strona) - left
destro - prawy (strona) - right
tardi - późno, później - late, later
non - nie - not
mentre - gdy, podczas gdy, natomiast - while
stampa - druk, prasa - press
notte - noc - night
reale - rzeczywisty - real
vita - życie - life
pochi - mało, odrobina - few
nord - północ - north
libro - książka - book
scienza - nauka - science
mangiare - jeść - eat
camera - pokój, izba - room
amico - kolega, przyjaciel - friend
idea - pomysł, myśl - idea
pesce - ryba - fish
montagna - góra - mountain
una volta - dawniej, kiedyś, pewnego razu - once
base - baza, podstawa - base
cavallo - koń - horse
taglio - cięcie - cut
sicuro - pewny, bezpieczny - sure
colore - kolor - color
volto - twarz, oblicze - face
legno - drewno - wood
principale - główny - main
aperto - otwarty - open
sembrare - wydawać się - seem
insieme - razem - together
prossimo - prossimo - next
bianco - biały - white
bambini - dzieciątko, dziecko - children
inizio - początek - begin
camminare - chodzić, iść - walk
esempio - przykład - example
alleviare - łagodzić, przynieść ulgę - ease
carta - papier - paper
gruppo - grupa - group
sempre - zawsze, ciągle - always
musica - muzyka - music
quelli - ci, tamci - those
entrambi - oba, obaj - both
spesso - często - often
lettera - list, litera - letter
fino a quando - aż do - until
miglio - mila - mile
fiume - rzeka - river
auto - samochód - car
a piedi - pieszo - on foot
cura - troska, opieka - care
secondo - drugi - second
abbastanza - dość, wystarczająco, całkiem - enough, quite
pianura - równina - plain
ragazza - dziewczyna - girl
solito - zazwyczaj - usual
giovane - młody - young
pronto - gotowy, przygotowany - ready
sopra - nad, ponad, powyżej - above
mai - nigdy - never
rosso - czerwony - red
elenco - lista, spis - list
anche se - chociaż - though
sentire - słyszeć, czuć, wyczuć - hear, feel
discussione - debata, dyskusja - talk
uccello - ptak - bird
corpo - ciało - body
cane - pies - dog
famiglia - rodzina - family
diretto - bezpośredni - direct
posa - poza, położenie - pose
lasciare - pozwolić, zostawić, wypuścić - let, leave
canzone - piosenka - song
misurare - mierzyć, zmierzyć, przymierzyć - measure
porta - drzwi, furtka, bramka - door
prodotto - produkt - product
nero - czarny - black
breve - krótki - short
numerale - liczbowy, numeryczny - numeral
classe - klasa - class
vento - wiatr - wind
domanda - pytanie - question
accadere - zdarzyć się - happen
integrale - całkowity, jednolity, razowy (chleb) - complete
nave - statek - ship
area - obszar - area
metà - połowa - half
ordine - porządek - order
fuoco - ogień - fire
sud - południe - south
problema - problem - problem
pezzo - część, kawałek - piece
passare - przechodzić/przejeżdżać przez, mijać, podać, przekazać, spędzić (czas), przeminąć (czas) - pass
da - z, od (osoba, kierunek, miejsce), przez - since, from, by
top - szczyt - top
tutto - całość, wszystko, wszyscy, cały - all, whole, everyone
re - król - king
pollice - kciuk - inch
moltiplicare - mnożyć - multiply
niente - nic - nothing
corso - kurs, przebieg (zdarzeń), deptak - course, progress, path
soggiornare - mieszkać, przebywać - stay
ruota - koło - wheel
completo - zestaw, komplet, kompletny, pełny - full
vigore - wigor, zapał, animusz - force
blu - niebieski - blue
oggetto - przedmiot, obiekt - object
decidere - zdecydować, postanawiać - decide
superficie - powierzchnia - surface
profondo - głęboki - deep
profondità - głębia, głębina, głębokość - deep
luna - księżyc - moon
isola - wyspa - island
piede - stopa - foot
sistema - system - system
occupato - zajęty - busy
test - test - test
record - rekord - record
barca - łódź - boat
comune - pospolity, zwyczajny, zwykły, wspólny - common
oro - złoto - gold
possibile - możliwy - possible
asciutto - suchy - dry
meraviglia - zachwyt, cud - wonder
ridere - śmiać się - laugh
migliaio - tysiąc - thousand
fa - temu (np. 2 lata temu) - ago
corsa - wyścig - race
correre - biegać, rywalizować - to run
controllare - kontrolować, nadzorować - check
gioco - gra - game
forma - forma, kształt - shape, form
uguagliare - wyrównać, dorównać - equate
perdere - stracić, zgubić, przegrać, - to lose, miss
calore - ciepło - heat
neve - śnieg - snow
pneumatico - opona - tire
sì - tak - yes
lontano - odległy, daleki, daleko - far, away, distant
riempire - napełnić, wypełnić - fill
est - wschód - east
dipingere - malować - paint
lingua - język - language
tra - między, za (czas, np. za godzinę) - between, among
potenza - moc, władza, potęga - power
città - miasto - town, city
fine - delikatny, drobny, koniec, zakończenie - thin, end, close
certo - pewny, pewien, pewnie, oczywiście - certain
volare - latać, lecieć, pędzić - fly
portare - nosić, przynieść, prowadzić, wieźć - carry, bring, lead
grido - krzyk, wołanie - shout, scream
scuro - ciemny - dark
macchina - maszyna, samochód - machine
nota - notatka, wyjaśnienie, nuta - note
figura - figura - figure
stella - gwiazda - star
scatola - pudełko, pojemnik - box
sostantivo - rzeczownik - noun
campo - pole (np. uprawne), branża, dziedzina - field, camp
resto - reszta - rest
corretto - poprawny, właściwy - correct
in grado di - zdolny do - able to
libbra - funt - pound
bellezza - piękno, uroda - beauty
unità - jednostka - unit
sorgere - wschodzić, wznosić się - to rise, arise
contenere - zawierać - contain
frontale - z przodu, czołowy - front
fronte - czoło, front - front
insegnare - uczyć - teach
settimana - tydzień - week
finale - finał, końcowy, ostateczny - final
verde - zielony - green
sviluppare - opracować, rozwinąć - develop
oceano - ocean - ocean
caldo - skwar, ciepły, gorący - hot, warm
gratuito - bezpłatny, darmowy - free
minuto - minuta - minute
speciale - specjalny, szczególny - special
mente - umysł - mind
dietro - za, z tyłu - behind
chiaro - jasny - clear
coda - ogon - tail
produrre - produkować, wytwarzać - produce
fatto - fakt - fact
spazio - przestrzeń, miejsce - space
sentito - słyszany, szczery, serdeczny - heard
il migliore - najlepszy - best
ora - teraz, godzina - now, hour
meglio - lepiej - better
vero - prawda - true
durante - podczas - during
cento - sto - hundred
cinque - pięć - five
ricordare - pamiętać, przypominać - remember
passo - krok - step
presto - wcześnie, wkrótce, szybko - soon, early
tenere - trzymać - hold
ovest - zachód - west
terra - ziemia, gleba - ground, earth, land
interesse - interes - interest
raggiungere - osiągnąć, dogonić - reach
veloce - szybki - fast, quick
verbo - czasownik - verb
cantare - śpiewać - sing
ascoltare - słuchać - listen
sei - sześć - six
tavolo - stół - table
meno - mniej - less
mattina - rano - morning
dieci - dziesięć - ten
semplice - prosty - simple
alcuni - jakiś, niektórzy - some, several
vocale - samogłoska - vowel
verso - do, w kierunku, wobec - toward
guerra - wojna - war
porre - położyć - lay
contro - kontra, versus, przeciw - against
modello - wzór, model - pattern
lento - powolny - slow
centro - środek, centrum - center
amore - miłość - love
persona - osoba - person
soldi - pieniądze - money
servire - służyć, podawać - serve
apparire - pojawić się, pokazać się - appear
strada - ulica, droga - road, street
mappa - mapa - map
pioggia - deszcz - rain
regola - reguła, przepis - rule
governare - rządzić - govern
tirare - ciągnąć, rzucać - pull
freddo - chłód, chłodny, zimny - cold
avviso - awizo, ostrzeżenie - notice
voce - głos - voice
energia - energia - energy
caccia - polowanie - hunt
probabile - prawdopodobny - probable
letto - łóżko - bed
fratello - brat - brother
uovo - jajo - egg
giro - obrót, okrążenie - round, ride
cella - cela - cell
credere - wierzyć - believe
forse - (być) może - perhaps
scegliere - wybierać, wybrać - pick
improvviso - nagle, nagły - sudden
contare - liczyć, policzyć - count
piazza - plac, rynek - square, place
motivo - powód - reason
lunghezza - długość - length
rappresentare - reprezentować, przedstawiać - represent
arte - sztuka - art
soggetto - temat, przedmiot - subject
regione - region - region
dimensione - wymiar, wielkość - size
variare - zmienić - change
risolvere - rozwiązać, rozstrzygnąć - to solve
parlare - mówić - speak
peso - ciężar - weight
generale - ogólny - general
ghiaccio - lód - ice
materia - materia, przedmiot - matter
cerchio - koło, krąg - circle
coppia - para - pair
includere - zawierać - include
dividere - dzielić - divide
sillaba - sylaba - syllable
feltro - filc - felt
grande - duży, świetny - big, large, grand, great
palla - piłka - ball
ancora - jeszcze - yet
onda - fala - wave
cadere - przewracać się - fall, drop
cuore - serce - heart
presente - obecny - present
pesante - ciężki, trudny - heavy
danza - taniec - dance
motore - silnik - engine
posizione - pozycja - position
braccio - ramię - arm
vela - żagiel - sail
materiale - materiał - material
frazione - frakcja - fraction
foresta - las - forest
sedersi - siadać - sit
gara - zawody, wyścig - contest, race
finestra - okno - window
negozio - sklep - store
estate - lato - summer
treno - pociąg - train
sonno - sen - sleep
dimostrare - udowadnić - prove
solitario - samotny - lonely
gamba - noga - leg
esercizio - ćwiczenie - exercise
muro - ściana, mur - wall
prendere - brać, złapać - catch, take
monte - góra - mount
desiderio - pragnienie, pożądanie - wish
cielo - niebo - sky
pensione - pensjonat - pension
gioia - radość - joy
inverno - zima - winter
scritto - pismo, napisany - written
selvaggio - dziki - wild
strumento - instrument - instrument
tenere - trzymać, brać - to hold
vetro - szkło, szyba - glass
erba - trawa - grass
mucca - krowa - cow
lavoro - praca - job, work
bordo - deska, pobocze - board, edge
segno - znak - sign
visita - wizyta, zwiedzanie - visit
passato - przeszłość - past
morbido - miękki - soft
divertimento - rozrywka, przyjemność - fun
luminoso - świecący - bright
gas - gaz - gas
tempo - czas, pogoda - time, weather
mese - miesiąc - month
milione - milion - million
sopportare - wytrzymywać, znosić - bear
finitura - koniec - finish
felice - szczęśliwy - happy
speranza - nadzieja - hope
fiore - kwiat - flower
vestire - ubierać (się) - clothe
strano - dziwny - strange
commercio - handel - trade
melodia - melodia - melody
viaggio - podróż - trip, travel
ufficio - biuro - office
ricevere - przyjmować, odbierać - receive
fila - szereg, rząd, kolejka - row
bocca - usta, pysk - mouth
esatto - dokładny - exact
simbolo - symbol - symbol
morire - umierać, usychać - die
meno - mniej - least
difficoltà - trudność - trouble
gridare - krzyczeć - shout
tranne - oprócz - except
seme - nasiono - seed
tono - ton - tone
aderire - przylegać, wstępować - stick, join
suggerire - sugerować - suggest
pulito - czysty - clean
pausa - przerwa - break
signora - pani - lady
cantiere - podwórze - yard
salire - wchodzić (na górę) - rise, go up
male - źle, zło - bad
colpo - uderzenie, cios - blow
olio - olej - oil
sangue - krew - blood
toccare - dotykać - touch
cresciuto - wzrost - growth
mescolare - mieszać - mix
filo - drut, nić - wire
costo - koszt - cost
perso - stracony - lost
marrone - brązowy - brown
indossare - ubierać, nosić - wear
giardino - ogród - garden
pari - równy, parzysty - equal
inviato - wysłany - sent
scegliere - wybierać - choose
caduto - upadek - fell
adattarsi - dopasować - fit
flusso - strumień - flow
fiera - targi - fair
banca - bank - bank
raccogliere - zbierać, podnosić - collect
salvare - zapisywać, ratować - save
controllo - kontrola - control
decimale - dziesiętny - decimal
orecchio - ucho - ear
altro - inny, coś innego - other, else
rotto - popsuty - broken
caso - przypadek - case
mezzo - środek - middle
uccidere - zabić - kill
figlio - syn - son
lago - jezioro - lake
momento - moment - moment
scala - schody, drabina - ladder
forte - silny, głośny - strong, loud
primavera - wiosna - spring
osservare - obserwować - observe
dritto - prosty - straight
consonante - spółgłoska - consonant
nazione - naród - nation
dizionario - słownik - dictionary
latte - mleko - milk
velocità - prędkość - speed
metodo - metoda - method
organo - organ - organ
pagare - płacić - pay
età - wiek - age
sezione - część, sekcja - section
vestito - ubranie, sukienka - dress
nube - chmura - cloud
sorpresa - niespodzianka - surprise
tranquillo - spokojny, cichy - quiet
pietra - kamień - stone
piccolo - mały - tiny, small
salita - podejście, podjazd - climb
povero - biedny - poor
lotto - los - lot
esperimento - eksperyment - experiment
fondo - dno, głęboki - bottom
chiave - klucz - key
ferro - żelazo - iron
singolo - pojedynczy - single
bastone - kij - stick
appartamento - mieszkanie - flat
venti - dwadzieścia - twenty
pelle - skóra - skin
sorriso - uśmiech - smile
piega - zagięcie - crease
foro - otwór - hole
salto - skok - jump
bambino - dziecko - baby
otto - osiem - eight
villaggio - wieś - village
incontrare - spotykać - meet
radice - korzeń - root
acquistare - kupować - buy
aumentare - zwiększać, podwyższać - increase, raise
risolvere - rozwiązywać - solve
metallo - metal - metal
se - jeśli, czy - if, whether
spingere - pchać, naciskać - push
sette - siedem - seven
paragrafo - paragraf - paragraph
terzo - trzeci - third
capelli - włosy - hair
descrivere - opisywać - describe
cuoco - kucharz - cook
piano - plan, piętro - plan, floor
o - lub - or
risultato - rezultat - result
bruciare - palić - burn
collina - wzgórze - hill
sicuro - bezpieczny, pewny - safe
gatto - kot - cat
secolo - wiek - century
considerare - rozważać - consider
tipo - typ, rodzaj - type, kind
legge - prawo, ustawa - law, act
costa - wybrzeże - coast
copia - kopia - copy
frase - zdanie - phrase
silenzioso - cichy - silent
alto - wysoki - tall, high
sabbia - piasek - sand
suolo - gleba - soil
rotolo - rolka, zwój - roll
temperatura - temperatura - temperature
dito - palec - finger
industria - przemysł - industry
valore - wartość - value
lotta - walka - fight
bugia - kłamstwo - lie
battere - bić - beat
eccitare - ekscytować - excite
naturale - naturalny - natural
senso - zmysł, sens - sense
capitale - stolica - capital
non sarà - nie będzie - won’t
sedia - krzesło - chair
pericolo - niebezpieczeństwo - danger
frutta - owoc - fruit
ricco - bogaty - rich
spesso - często, gruby - often, thick
soldato - żołnierz - soldier
processo - proces - process
operare - działać, obsługiwać - operate
pratica - praktyka - practice
separato - oddzielny - separate
difficile - ciężki, trudny - difficult, hard
medico - lekarz - doctor
per favore - (po)proszę - please
proteggere - chronić - protect
mezzogiorno - południe - noon
raccolto - plon - crop
moderno - nowoczesny - modern
elemento - element - element
colpire - uderzać, trafiać - hit
studente - uczeń, student - student
angolo - róg, kąt - corner
partito - partia - party
fornitura - zaopatrzenie, dostawa - supply
la cui - czyj - whose
individuare - zidentyfikować, rozróżnić - locate
anello - pierścionek - ring
carattere - charakter - character
insetto - owad - insect
catturato - złapany, zatrzymany - caught
periodo - okres - period
indicare - wskazywać - indicate
radio - radio - radio
raggio - promień - spoke
atomo - atom - atom
umano - człowiek - human
storia - historia, historyjka, opowieść - history, story
effetto - skutek, efekt - effect
elettrico - elektryczny - electric
aspettare - czekać, oczekiwać - wait, expect
osso - kość - bone
ferrovia - kolej - rail
immaginare - wyobrazić, myśleć - imagine
fornire - zaopatrzyć, dostarczyć - provide
concordare - zgodzić się, uzgodnić - agree
così - więc - so
dolce - słodki, łagodny - sweet, gentle
donna - kobieta - woman
capitano - kapitan - captain
indovinare - zgadywać - guess
necessario - konieczny, niezbędny - necessary
tagliente - ostry - sharp
ala - skrzydło - wing
creare - tworzyć - create
prossimo - następny - next one
lavaggio - myć, mycie, pranie - wash
pipistrello - nietoperz - bat
piuttosto - raczej - rather
folla - tłum - crowd
mais - kukurydza - corn
confrontare - porównać - compare
poesia - poezja - poem
stringa - sznur, struna - string
campana - dzwon - bell
dipendere - zależeć - depend
carne - mięso - meat
strofinare - wycierać - rub
tubo - rura - tube
famoso - sławny - famous
ruscello - potok, strumień - stream
paura - strach - fear
vista - wzrok - sight
sottile - cienki - thin
triangolo - trójkąt - triangle
pianeta - planeta - planet
fretta - fretta - hurry
capo - głowa, szef - chief
colonia - kolonia - colony
orologio - zegarek - clock, watch
miniera - kopalnia - mine
cravatta - krawat - tie
inserire - wkładać, wstawiać - insert, enter
maggiore - większy, starszy - greater, major
fresco - świeży - fresh
ricerca - badania, poszukiwania - research, search
inviare - wysyłać - send
giallo - żółty - yellow
pistola - pistolet - gun
consentire - pozwalać - allow
stampa - druk, prasa - print
morto - martwy - dead
spot - miejsce - spot
deserto - pustynia - desert
tuta - dres, kombinezon - tracksuit
corrente - obecny, bieżący - current
ascensore - winda - lift
rosa - róża, różowy - rose
arrivare - przybyć - arrive
master - mistrz - master
pista - ślad, tor - track
genitore - rodzic - parent
riva - brzeg, wybrzeże - shore
divisione - podział - division
foglio - kartka, arkusz - sheet
sostanza - substancja - substance
favorire - przysługa, wsparcie - help, favor
collegare - łączyć - connect
messaggio - wiadomość - post
spendere - wydawać, spędzać - spend
accordo - zgodność, porozumienie - agreement
grasso - gruby, tłusty - fat
felice - szczęśliwy - happy, glad
originale - oryginalny - original
quota - udział, kwota - share
stazione - stacja - station
papà - tata, papież - dad, pope
mamma - mama - mom
pane - chleb - bread
carica - opłata - charge
corretto - poprawny, prawidłowy - correct, proper
bar - bar - bar
offerta - oferta - offer
segmento - człon, odcinek - segment
schiavo - niewolnik - slave
anatra - kaczka - duck
immediato - bezpośredni natychmiastowy - instant
mercato - rynek, targ - market
grado - stopień - degree
popolare - popularny - populate
pulcino - pisklę - chick
caro - drogi, kochany, kosztowny - dear
nemico - wróg - enemy
rispondere - odpowiedź - reply
bevanda - napój - drink
verificarsi - wystąpić, pojawić się - occur
supporto - wsparcie - support
discorso - przemówienie - speech
natura - przyroda, natura - nature
gamma - zasięg, zakres - range
vapore - para, parowy - steam
moto - motocykl, ruch - motorcycle, motion
sentiero - ścieżka - path
liquido - płyn, płynny - liquid
significare - znaczyć - mean
quoziente - iloraz - quotient
denti - zęby - teeth
guscio - muszla - shell
collo - szyja - neck
ossigeno - tlen - oxygen
zucchero - cukier - sugar
morte - śmierć - death
piuttosto - raczej - pretty
bello - piękny - beautiful
abilità - umiejętność - skill
donne - kobiety - women
stagione - sezon, pora roku - season
soluzione - rozwiązanie - solution
magnete - magnes - magnet
argento - srebro - silver
grazie - dzięki - thanks
ramo - oddział - branch
partita - mecz - match
suffisso - przyrostek - suffix
particolarmente - szczególnie - especially
fico - figa - fig
impaurito - przestraszony - afraid
enorme - olbrzymi, ogromny - huge
sorella - siostra - sister
acciaio - stal - steel
discutere - dyskutować - to discuss
avanti - naprzód - forward
simile - podobny - similar
guidare - jechać - to drive
esperienza - doświadczenie - experience
punteggio - wynik - score
mela - jabłko - apple
comprato - kupiony - bought
portato - przyniesiony - led, brought
pece - smoła - pitch
cappotto - płaszcz - coat
massa - masa - mass
scheda - karta, zakładka - card
banda - zespół, gang - band
corda - line - rope
slittamento - poślizg - slip
vittoria - zwycięstwo - win
sognare - sen, marzenie - dream
sera - wieczór - evening
condizione - stan - condition
alimentazione - odżywiazasilacz - supply, feed
strumento - narzędzia - tool
totale - całkowity, ogólny - total
di base - podstawowy - basic
odore - zapach - smell
valle - dolina - valley
né - ani - nor
doppio - podwójny - double
sedile - siedzenie - seat
continuare - kontynuować - continue
blocco - blok - block
grafico - wykres, grafika - chart, graphic
cappello - czapka - hat
vendere - sprzedaż - sell
successo - sukces - success
azienda - firma - company
sottrarre - odjąć, odejmować - subtract
evento - zdarzenie - event
particolare - szczegół, szczególny - particular
affare - sprawa - deal
nuoto - pływać - swim
termine - termin - term
opposto - naprzeciwko - opposite
moglie - żona - wife
scarpa - but - shoe
spalla - ramię - shoulder
organizzare - organizować - arrange
inventare - wynaleźć - invent
cotone - bawełna - cotton
nascita - urodziny, narodziny - birth
determinare - określić - determine
quarto di gallone - kwarta, - quart
nove - dziewięć - nine
camion - ciężarówka - truck
rumore - hałas - noise
livello - poziom - level
possibilità - możliwość - chance
raccogliere - zbierać - collect, gather
tratto - odcinek - stretch
gettare - rzucać - throw
shine - połysk, błyszczeć - shine
proprietà - nieruchomość - property
colonna - kolumna - column
molecola - cząsteczka - molecule
selezionare - wybrać - select
sbagliato - zły, źle - wrong
grigio - szary - gray
ripetizione - powtórzyć - repeat
richiedere - prośba, wniosek - request, require
ampio - duży, obszerny - large, wide
preparare - przygotować - prepare
sale - sól - salt
naso - nos - nose
plurale - liczba mnoga - plural
rabbia - złość - anger
richiesta - prośba - request
continente - kontynent - continent
qualcosa - coś - something
oggi - dzisiaj - today
domani - jutro - tomorrow
Mi scusi! - Przepraszam! - Excuse me!
scusa - przeprosiny, wymówka - excuse
colpa - wina - fault
ieri - wczoraj - yesterday
quanti - ile - how many
attenzione - uwaga - attention
fantastico - wspaniały, rewelacyjny, świetny - wonderful
Cristo - Chrystus - Christ
capire - rozumieć - understand
colazione - śniadanie - breakfast
pranzo - obiad - dinner
cena - kolacja - supper
zitto - milczeć; Milcz! - shut up
bastardo - drań - bastard
bagno - łazienka, kąpiel - bathroom
toilette - toaleta - toilet
traduzione - tłumaczenie - translation
sicurezza - bezpieczeństwo - security
Natale - Boże Narodzenie - Christmas
Pasqua - Wielkanoc - Easter
buonanotte - dobranoc! - good night
chiuso - zamknięty - closed
stanotte - tej nocy, dziś wieczorem - tonight
caffè - kawa - coffee
silenzio - cisza, spokój - silence
arrivederci - do widzenia - goodbye
incidente - wypadek - accident