a partir de - począwszy od, od - from, as of
a través de - przez, poprzez - through, across
a - do, przy - a, to
abajo - w dół, na dół, na dole - down, below, downstairs
abandonar - porzucać, opuszczać - to abandon
abrir - otwierać - to open, unlock
absoluto - zupełny, całkowity - absolute
abuelo - dziadek - grandfather, grandpa
acabar - kończyć - to finish
acaso - może - perhaps, maybe
acción - czyn, czynność, działanie - action
aceptar - akceptować, zgadzać się - to accept
acercarse - zbliżać się - to approach
acompañar - towarzyszyć - to accompany
acordar - uzgodnić - to decide
acordarse - pamiętać, przypominać sobie - to decide
actitud - postawa, stanowisko - attitude
actividad - zajęcie, aktywność, zadanie - activity
acto - czyn, akt - act
actual - obecny, aktualny - present
actuar - grać (np. w filmie), odgrywać rolę - to act
acudir - przybyć, stawić się - to go, come
acuerdo - zgoda, ok - agreement
adelante - naprzód, proszę wejść - ahead
además (de) - oprócz tego, że - in addition (to), besides, furthermore
adquirir - uzyskać, nabyć - to acquire
advertir - ostrzegać, zwracać uwagę - to notice, warn
afectar - dotykać, poruszać - to affect
afirmar - potwierdzać, stwierdzać - to affirm
agua - woda - water
ahí - tam - there
ahora - teraz - now
aire - powietrze - air
al - do - to, to the
alcanzar - osiągać, dosięgać - to reach
alejarse - oddalać się - to move away, remove
alemán - Niemiec, niemiecki - German
algo - coś - something
alguien - ktoś - somebody, someone
algún - jakiś, pewien - some, any
allí - tam - there
alma - dusza - soul
alto - wysoki - tall, high
altura - wysokość - height
amar - kochać - to love
ambos/as - oba, obydwa, oboje - both
americano - Amerykanin, amerykański - American
amigo/a - kolega, przyjaciel - friend
amor - miłość - love
amplio/a - szeroki, obszerny - large, wide
añadir - dodawać - to add
análisis - analiza - analysis
andar - chodzić, działać - to walk
animal - zwierzę - animal
año - rok - year
ante - przed, wobec, w obecności - before, in front of
antes - przedtem, wcześniej - before
anterior - poprzedni, uprzedni, wcześniejszy - previous
antes de - przed - before
antiguo/a - stary, dawny, starożytny - ancient, old
anunciar - ogłaszać, reklamować, zapowiadać - to announce
aparecer - pojawiać się - to appear
apenas - ledwo, zaledwie - hardly, scarcely
aplicar - (za)stosować - to apply
apoyar - popierać, wspierać - to support, lean
aprender - (na)uczyć się - to learn
aprovechar - (s)korzystać, wykorzystać - to take advantage of
aquel - tamten - that
aquello/a - tamto/tamta - that
aquí - tutaj - here
árbol - drzewo - tree
arma - broń - weapon
arriba - do góry, w górę - up
arte - sztuka - art
asegurar - zapewniać, ubezpieczać - to assure
así como - tak jak - as well as, such, like that
así que - więc - so, therefore
así - w ten sposób - like this
aspecto - wygląd, aspekt - aspect
asunto - sprawa, kwestia - matter, bussiness
atención\ciones - uwaga, wzgląd - attention
atrás - za, z tyłu, w tyle - back, behind
atreverse - odważyć się - to dare
aumentar - wzrastać, zwiększać - to increase, raise
aun - nawet - even
aún - jeszcze - still
aunque - chociaż, mimo że - though
auténtico/a - prawdziwy, autentyczny - authentic
autor/a - autor, twórca - author
autoridad - władze, autorytet - authority
avanzar - iść naprzód, robić postępy - to advance
ayer - wczoraj - yesterday
ayuda - pomoc - aid, help
ayudar - pomagać - to help
azul - niebieski - blue
bajar - schodzić (po schodach), zjeżdżać (windą), obniżać - to bring down, lower, go down
bajo/a - niski, pod, bas - low, short, faint
barrio - dzielnica, osiedle - neighborhood
base - podstawa, baza - base, basis
bastante - dosyć, dość, wystarczająco - fairly, rather
bastar - wystarczać - to be enough, suffice
beber - pić - to drink
bien - dobrze, dobro, w porządku - well, all right
blanco/a - biały - white
boca - usta - mouth
brazo - ramię, ręka - arm
buen(o) - dobry - good
buscar - szukać - to look for, to seek
caballo - koń - horse
cabeza - głowa - head
cabo - koniec - end, stub
llevar a cabo - doprowadzić do końca, skończyć - carry out
cada - każdy, każda - each
cadena - łańcuch, kanał telewizyjny - chain
caer - upaść, spaść - to fall
calle - ulica - street
cama - łóżko - bed
cambiar - zmieniać, wymieniać - to change
cambio - zmiana, wymiana - change
caminar - iść, wędrować - to walk
camino - droga - road
campaña - kampania - countryside
campo - wieś, pole, boisko - field
cantar - śpiewać - to sing
cantidad - ilość - quantity
capacidad - zdolność, pojemność - capacity
capaz\paces - zdolny (do czegoś) - able
capital - stolica - capital
cara - twarz - face
carácter\teres - charakter - character
carne - mięso - meat
carrera - wyścig, kariera, kierunek studiów - running
carta - list - letter
casa - dom, mieszkanie - house
casado/a - żonaty/mężatka - married
casarse - pobrać się - to marry
casi - prawie - almost
caso - przypadek - case
causa - powód, przyczyna - cause, reason
celebrar - świętować, obchodzić - to celebrate
móvil - telefon komórkowy - mobile
central - centralny, główny - central
centro - centrum, środek, ośrodek - center, downtown
cerebro - mózg - brain
cerrar - zamykać - to close
chica - dziewczyna - girl
chico - chłopak - boy
cielo - niebo - sky, heaven
ciencia - nauka - science
científico/a - naukowy, naukowiec - scientific
cien(to) - sto - hundred
cierto/a - racja, pewny - true, certain
cinco - pięć - five
cine - kino - cinema, movies
circunstancia - okoliczność - circumstance
ciudad - miasto - city
ciudadano/a - obywatel - citizen
civil - cywilny - civil
claro/a - jasne, jasny - clearly, clear
clase - klasa, lekcja - class
coche - samochód - car, automobile, coach, carriage
coger - brać, zbierać - to take
coger el metro/taxi - wsiąść do metra/taksówki (wziąć taksówkę) - take the subway/taxi
colocar - umieścić, ustawić - to place, put
color - kolor - color
comentar - komentować, objaśniać - to comment, discuss, mention
comenzar - zaczynać - to begin, start
comer - jeść - to eat
como - jako że, tak jak - as, since, like
cómo - jak, jaki, jaka - how
compañero/a - towarzysz, kolega - partner, companion
compañía - kompania, towarzystwo - company
completo - kompletny, cały - complete, full
comprar - kupić - to buy, purchase
comprender - rozumieć - to comprehend, to understand
comprobar - sprawdzić - to check
común\munes - wspólny, powszechny, zwykły - common
comunicación\ciones - komunikacja, łączność - communication
con - z - with
concepto - pojęcie, myśl, koncept - concept
conciencia - świadomość, sumienie - conscience
concreto - konkretny, rzeczowy - concrete, specific
condición\siones - warunek, stan, sytuacja - condition
conducir - prowadzić (pojazd) - to drive
conjunto - całość, komplet - joint, outfit, band
conocer - znać, poznać - to know, meet
conocimiento - wiedza, znajomość - knowledge
consecuencia - konsekwencja, skutek - consequence
conseguir - osiągnąć, zdobyć - to obtain
conservar - zachowywać, konserwować - to conserve
considerar - rozważać, uważać (za coś, za kogoś) - to consider
consistir (en) - polegać (na czymś) - to consist (of)
constante - stały, niezmienny - constant
constituir - stanowić, tworzyć - to constitute
construir - budować, konstruować - to construct, build
contacto - kontakt - contact
contar - liczyć, opowiadać - to count
contemplar - kontemplować - to contemplate
contener - zawierać - to contain
contestar - odpowiadać - to answer, reply
continuar - kontynuować - to continue
contra - przeciw - against
contrario - przeciwny - opposite
control - kontrola, panowanie - control, check
controlar - kontrolować, sprawdzać - to control
convencer - przekonać - to convince
conversación - rozmowa - conversation
convertir - przemieniać, nawracać - to turn into, convert
corazón - serce - heart
correr - biegać - to run, race
corresponder - odpowiadać (czemuś) - to correspond, belong
corriente - zwykły, bieżący, prąd - current
cortar - ciąć, obcinać, kroić - to cut
cosa - rzecz - thing
costumbre - zwyczaj - custom, habit
crear - tworzyć - to create
crecer - rosnąć, wzrastać - to grow, increase
creer - wierzyć - to believe
crisis - kryzys - crisis
cruzar - przechodzić (przez), krzyżować - to cross
cuadro - obraz, ramka, tabela - picture, square, painting
cual - który - as, like
¿cuál? - który/a? - which, what?
cualquier - każdy, jakikolwiek - any
cuando - kiedy - when
cuanto - ile - how much, as
¿cuánto? - ile? - how much?
cuarto/a - pomieszczenie, kwadrans, ćwierć, czwarty - room, quarter, fourth
cuatro - cztery - four
cubrir - zakrywać, pokrywać - to cover
cuenta - rachunek, konto - count
cuerpo - ciało - body
cuestión\tiones - sprawa, kwestia - matter, affair
cultura - kultura - culture
cultural - kulturalny, kulturowy - cultural
cumplir - wypełnić, spełnić - to accomplish, carry out
cuyo/a - którego/której, czyj/a - whose, of whom
dar - dawać - to give
dato - informacja - data
de - od, z, do - of, from
deber - musieć, obowiązek, zadanie - to owe
decidir - decydować - to decide
decir - powiedzieć, mówić - to say, tell
decisión - decyzja - decision
declarar - deklarować - to declare
dedicar - dedykować, przeznaczać - to dedicate
dedo - palec - finger, toe
defender - bronić - to defend
defensa - obrona - defense
definir - definiować, określać, ustalać - to define
definitivo - ostateczny, definitywny - definitive
dejar - zostawić, pozwolić, pożyczyć - to leave
del - z, od - of, from
demás - pozostali, reszta - rest of the
demasiado - zbyt dużo, zbyt, za bardzo - too much
demostrar - okazać, dowieść - to demonstrate
dentro de - w, wewnątrz - within, in
depender - zależeć - to depend
derecha - prawa, prawica - right
derecho - proste - straight, rigth
desaparecer - zniknąć - to disappear
desarrollar - rozwijać - to develop
desarrollo - rozwój - development
desconocer - nie znać, nie wiedzieć - to not know, fail to recognize
descubrir - odkryć - to discover
desde que - od kiedy - since
desde - od, z - from, since
desear - życzyć, pragnąć, pożądać - to wish
deseo - życzenie, pragnienie - desire
despertar - budzić - to wake up
después de - po - after
después - potem - afterwards, then
destino - przeznaczenie, miejsce przeznaczenia, cel - destiny, destin
detener - powstrzymać, aresztować - to stop
determinar - określić, ustalić - to determine
detrás - za, z tyłu - behind
día - dzień - day
diario/a - codzienny, dziennik - newspaper
diez - dziesięć - ten
diferencia - różnica - difference
diferente - inny, różny - different
difícil - trudny - difficult
dificultad - trudność - difficulty
dinero - pieniądze - money
dios - Bóg - God
dirección - adres, kierunek - address, direction
directo - bezpośredni - direct, straight
director/a - dyrektor - director, manager
dirigir - kierować - to direct
disponer - zarządzać, dysponować - to arrange
distancia - dystans, odległość - distance
distinto - odmienny - different
diverso - różny, rozmaity - diverse
doble - podwójny - double
doctor/a - doktor - doctor
dolor - ból - pain
donde - gdzie - where
¿dónde? - gdzie? - where?
domingo - niedziela - Sunday
dormir - spać - to sleep
dos - dwa - two
duda - wątpliwość - doubt
durante - podczas - during
duro - twardy, ciężki, trudny - hard
echar - (wy)rzucać, nalewać, nasypać - to throw, cast
echar de menos - tęsknić - miss
económico - ekonomiczny, tani - economic, economical
edad - wiek - age
efecto - skutek, efekt - effect
ejemplo - przykład - example
él - on - he, him
elección - wybór - choice, election
elegir - wybierać - to choose, select
elemento - element, pierwiastek, żywioł - element
elevar - podnosić - to elevate, raise
empezar - zaczynać - to begin, start
empresa - firma, przedsiębiorstwo - company
en - w, na - in, into, inside, on
encender - włączyć, zapalić - to light, switch on, set fire to
encima - na (powierzchni) - on top
encontrar - znaleźć, spotkać - to find
encuentro - spotkanie - encounter, meeting
energía - energia - energy
enfermedad - choroba - illness, disease, sickness
enfermo - chory - ill, sick
enorme - ogromny - enormous
enseñar - uczyć, pokazywać - to teach
entender - rozumieć - to understand
enterarse - dowiedzieć się - to find out, inform
entonces - więc, zatem, wtedy - then
entrada - wejście, wejściówka - entrance, entry
entrar - wchodzić - to enter
entre - pomiędzy - between, among
entregar - dawać, wręczać - to deliver, give
enviar - wysyłać - to send
época - epoka, okres - epoch, period
equipo - drużyna, sprzęt - equipment, team
error - błąd, pomyłka - error, mistake
es decir - to znaczy - that is to say
escapar - uciec, zbiec - to escape, run away
escribir - pisać - to write
escritor/tora - pisarz - writer
escuchar - słuchać - to listen, heard
ese/a - ten/ta - that
esfuerzo - wysiłek - effort, endeavor, exertion
eso - to - that
espacio - przestrzeń, kosmos - space
espalda - plecy - back
España - Hiszpania - Spain
español - hiszpański, Hiszpan - spanish
especial - specjalny - special
especie - gatunek, rodzaj - species
esperanza - nadzieja - hope, prospect
esperar - mieć nadzieję, czekać - to hope, wait
espíritu - duch - spirit
está - jest, znajduje się - is
establecer - ustanowić - to establish
estado - stan, państwo - state
Estados Unidos - Stany Zjednoczone - United States
estar - być, znajdować się - to be, stay
éste/a - ten/ta (bez rzeczownika) - this one
este/a - ten/ta (z rzeczownikiem) - this
esto - to - this
estoy - jestem - I am
estrella - gwiazda - star
estructura - budowa, struktura - structure
estudiar - studiować, uczyć się - to study
estudio - studium, studio, pracownia - study, studio
estudios - studia - studies
etapa - etap - stage
Europa - Europa - Europe
europeo - europejski - European
evidente - oczywisty - evident
evitar - unikać - to avoid
exacto/a - dokładny precyzyjny - exact
exigir - wymagać - to demand
existencia - istnienie, egzystencja, byt - existence
existir - istnieć - to exist
éxito - sukces - success
experiencia - doświadczenie - experience
explicar - tłumaczyć - to explain
expresión - wyrażenie - expression
extender - rozpowszechniać, rozprzestrzeniać - to extend
exterior - zewnętrzny - outside, exterior
extranjero/a - cudzoziemiec, zagraniczny - foreigner, foreign
extraño - dziwny, obcy - strange, foreign
extremo - skrajny, kraniec - extreme
fácil - łatwy - easy
falta - brak - lack
faltar - brakować - to lack
familia - rodzina - family
familiar - rodzinny, krewny, dobrze znany - familial, family
famoso - znany - famous
fenómeno - zjawisko, fenomen - phenomenon
fiesta - święto, impreza, dzień wolny - celebration, party
figura - postać, kształt - figure, shape
imaginarse - wyobrażać sobie - to imagine
fijar - przymocować, utkwić - to faten, affix
fijarse en - zwrócić uwagę na - to faten, affix
fin - koniec - end
fin de semana - weekend - weekend
final - końcowy, zakończenie, finał - end, final
físico - fizyk, fizyczny - physical, physicist
flor - kwiat - flower
fondo - dno, tło, głębia - bottom, rear
forma - kształt, sposób - shape
formar - tworzyć - to form
francés - francuski, Francuz - french
Francia - Francja - France
frase - zdanie - phrase
frecuencia - częstotliwość - frequency
frente - czoło, przód - in front
frío/a - zimno, zimny - cold, cool
fuego - ogień - fire
fuente - źródło, fontanna - source
fuera de - na zewnątrz, poza - outside of, beyond
fuerte - silny, mocny - hard, strong
fuerza - siła, moc - force, strength
función - funkcja - function
funcionar - funkcjonować, działać - to work, run, function
fundamental - podstawowy - fundamental
fútbol - piłka nożna - soccer, football
futuro - przyszłość - future
ganar - wygrywać, zarabiać - to win
general - ogólny - general
gente - ludzie - people
gesto - gest, mina - gesture
gobierno - rząd - government
golpe - uderzenie, cios - blow
gracia - łaska - grace
gracias - dziękuję - thanks
gran(de) - duży - big, great
grave - poważny - grave, deep
gritar - krzyczeć - to shout, scream
grupo - grupa - group
guardar - zachować, przechowywać - to keep
guerra - wojna - war
gustar - podobać się, lubić - to taste, like
gusto - gust, smak - taste, pleasure, liking
haber - czasownik posiłkowy, być, znajdować się - to have, has
habitación - pokój, pomieszczenie - room, bedroom
habitual - zwyczajowy - habitual, usual
hablar - rozmawiać - to speak, talk
hacer - robić - to do, make
hacia - w kierunku, do, około - towards
hallarse - znajdować się - to find, discover
hasta que - aż do - until, even
hasta - aż, do - until, even
hecho/a - fakt, załatwione, zrobione - fact
hermana - siostra - sister
hermano - brat - brother
hermoso/a - piękny - beautiful
hija - córka - daughter
hijo - syn - son
historia - historia - history
histórico - historyczny - historical
hombre - człowiek, mężczyzna - man
hombro - ramię, bark - shoulder
hora - godzina - hour
hoy - dzisiaj - today
humano/a - ludzki, człowiek - human
idea - pomysł - idea
iglesia - kościół - church
igual - taki sam, jednakowy - equal
imagen\imágenes - wizerunek, obraz, zdjęcie - image
imaginar - wyobrażać - to imagine
impedir - uniemożliwić - to prevent
imponer - narzucić, wzbudzać respekt - to impose, command
importancia - ważność, znaczenie - importance
importante - ważny - important
importar - obchodzić, być ważnym, importować - to matter, be important
imposible - niemożliwy - impossible
incluir - włączyć, przyłączyć - to include
incluso - nawet, włącznie - even, in fact
indicar - wskazywać - to indicate
individuo - osobnik, jednostka - individual
información\ciones - informacja - information
informar - informować - to inform
inglés - angielski, Anglik - English
iniciar - inicjować, zaczynać - to initiate
inmediato/a - natychmiastowy - immediate
insistir - nalegać - to insist
instante - chwila - moment, instant
intentar - próbować - to try
interés\reses - zainteresowanie, zysk - interest
interesar - interesować - to interest
interior - wewnętrzny, wnętrze - interior, inner
internacional - międzynarodowy - international
introducir - wprowadzać, wkładać - to introduce, insert
ir - iść, jechać - to go
izquierda - lewa, lewica - left
jamás - nigdy - never
jefe/a - szef - chief, leader, boss
joven - młody, młodzieniec - young person
juego - gra, zabawa - game, playing
jugador - gracz - player, gambler
jugar - grać, bawić się - to play, gambler
juicio - sąd, osąd, rozum - judgment, sense
junto - razem, blisko, obok - together, joined, close
justo - sprawiedliwy, słuszny, akurat - just, fair
labio - warga - lip
lado - strona, bok - side
lanzar - rzucać - to throw
largo - długi - long
lector/tora - czytelnik - reader
leer - czytać - to read
lengua - język - language, tongue
lenguaje - mowa, język - language
lento - wolny - slow
levantar - podnosić - lift, raise
levantarse - wstawać - stand up, get up
ley - prawo, ustawa - law
libertad - wolność - freedom
libre - wolny - free
libro - książka - book
limitar - ograniczać - to limit
línea - linia - line
listo - gotowy, sprytny, prosty - ready, clever
literatura -  literatura - literature
llamar - zadzwonić przez telefon, zapukać - to call, knock
llamarse - nazywać się - to be called
llegar - przybyć, dotrzeć - to arrive, come
llenar - napełniać - to fill
lleno - pełny, przepełniony - full
llevar - nosić, mieć na sobie - to take, carry
llorar - płakać - to cry, weep
lo - to - the for it
loco/a - szalony - crazy, insane
lograr - zdobyć, osiągnąć - to obtain, achieve, get
lucha - walka - fight, struggle
luego - potem, następnie - then, later
lugar - miejsce - place
lunes - poniedziałek - Monday
luz - światło, elektryczność - light, lighting
madre - matka - mother
mal - źle, zło - badly, poorly, incorrectly
malo/a - zły, chory - bad
mañana - jutro, rano - tomorrow
mandar - rozkazywać, wysyłać - to command
manera - sposób - way, manner
manifestar - okazywać - to declare
mano - dłoń, ręka - hand
mantener - utrzymywać,  żywić - to maintain
máquina - maszyna, urządzenie - machine
mar - morze - sea
marcar - zaznaczać, wskazywać - to mark
marcha - marsz, funkcjonowanie - march
marchar - maszerować - to march
marcharse - odejść, wyjechać - leave, go away
marido - mąż - husband
mas - lecz - but
más - więcej, bardziej, plus - more
más o menos - mniej więcej - more or less
masa - masa, surowe ciasto - mass
matar - zabić - to kill
materia - substancja, przedmiot szkolny - matter
material - materiał, surowiec - material
máximo - maksymalny - maximum
mayor - starszy, większy - greater
mayoría - większość - majority
medio/a - średni - means
mediante - poprzez, za  pomocą - by means of
médico/a - lekarz - doctor
medida - miara - measurement
en el medio - w środku - in the middle
medio ambiente - środowisko - environment
mejor - lepszy, lepiej - better
memoria - pamięć - memory
menor - młodszy, nieletni, mniejszy - minor
menos - mniej, minus - less
por lo menos - przynajmniej - at least
mensaje - wiadomość, SMS - message
mental - umysłowy, psychiczny - mental
mente - umysł - mind
a menudo - często - often
mercado - rynek, targ, (super)market - market
merecer - zasługiwać, być wartym - to deserve
mes -  miesiąc - month
mesa - stół - it pulls
meter - włożyć, wsadzić - to put
método - metoda, sposób - method
metro - metr, metro - meter
mi - mój, moja - my
mí - mnie, mi - me
miedo - strach - fear
miembro - członek - member
mientras que - podczas gdy - whereas, while
mientras - tymczasem - while
mil - tysiąc - thousand
militar - wojskowy - military man
millón - milion - million
mínimo/a - minimalny - minimum
ministro/a - minister - minister
minuto - minuta - minute
mío/a - mój - mine
mirada - spojrzenie - watched
mirar - oglądać, patrzeć - to watch
mismo - to samo - same
mitad - połowa - half
modelo - model, modelka, wzorzec - model
moderno/a - nowoczesny - modern
modo - sposób, tryb - way, manner, mode
momento - moment, chwila - moment
moral - moralny, morale - moral
morir - umierać - to die
mostrar - pokazywać, okazywać - to show
motivo - motyw, powód - reason
mover - ruszać - to move, stir
movimiento - ruch - movement, motion
muchacho - chłopak - boy
mucho - dużo - much
muerte - śmierć - death
mujer - kobieta - woman
mundial - światowy, mundial - worldwide
mundo - świat - world
música - muzyka - music
muy - bardzo - very, highly
nacer - urodzić się - to be born
nacional - narodowy, państwowy - national
nada - nic - nothing
nadie - nikt - nobody, no-one
natural - naturalny - natural
naturaleza - przyroda, natura - nature
necesario/a - potrzebny - necessary
necesidad - potrzeba - necessity,need
necesitar - potrzebować - to need
negar - przeczyć, odmawiać - to deny
negocio - interes, biznes - business
negro - czarny, Murzyn - black
ni siquiera - nawet nie, ani - not even
ni - ni, ani - nor, neither
niño - dziecko, chłopiec - child, boy
niña - dziewczynka - girl
ningún - żaden - none
nivel - poziom - level
no - nie - no
noche - wieczór, noc - night
nombre - imię - name
notar - zauważyć - to notice
noticia - wiadomość, nowina - the news
novela - powieść - novel
nuestro/a - nasz - ours
nuevo/a - nowy - new
número - liczba, numer - number
nunca - nigdy - never
o - albo, lub - or
objetivo - obiektywny, cel - objective
objeto - przedmiot - object
obligar - zmusić, zobowiązać - to force, oblige
obligatorio/a - obowiązkowy - required
obra - dzieło, sztuka (teatralna) - work
observar - obserwować - to observe
obtener - otrzymać - to obtain, get
ocasión - okazja - chance
ocho - osiem - eight
ocupar - zajmować, okupować - to occupy
ocuparse - zajmować się - take care
ocurrir - wydarzyć się - to happen
oficial - oficjalny, urzędowy - official
ofrecer - oferować, dać - to offer
oír - słyszeć - to hear
ojo - oko - eye
olvidar - zapomnieć - to forget
operación - operacja - operation
opinión - opinia - opinion
origen\rígenes - pochodzenie, początek - origin
oro - złoto - gold
oscuro/a - ciemny - dark, obscure
otro/a - inny, kolejny - another, other
otra vez - jeszcze raz - again
paciente - cierpliwy, pacjent - patient
padre - ojciec - father
pagar - płacić - to pay
página - strona - page
país - kraj - country, nation
palabra - słowo - word
papel - papier - paper
un par (de) - para (czegoś) - a pair (of)
para que - aby - so that
para - dla, aby - for, towards, stop
parar - zatrzymać - to stop, stand
parecer - wydawać się - to seem
pared - ściana - wall
pareja - para, partner(ka) - even, couple, pair
parte - część - part
participar - uczestniczyć - to participate
particular - prywatny, szczególny - particular, private
partido - partia, mecz - party, game
partir - dzielić, rozbijać, wyruszać - to start off, depart, slipt, divide
pasado - przeszłość, miniony - past
pasar - dziać się, puszczać (np. w radiu), przekazywać - to happen, pass
paso - krok - step
paz - pokój, spokój - peace
pecho - klatka piersiowa, pierś - chest
pedir - prosić - to request, ask for
película - film - film, movie
peligro - niebezpieczeństwo - danger
peligroso - niebezpieczny - dangerous
pelo - włosy - hair
pena - ból, troska, kara - pain, penalty
pensamiento - myśl - thought
pensar - myśleć, zamierzać - to think
peor - gorszy - worse
pequeño - mały - little
perder - zgubić, stracić - to lose, miss
perfecto - doskonały - perfect
periódico - gazeta - newspaper
periodista - dziennikarz - journalist
permanecer - pozostawać, trwać - to remain
permitir - pozwolić - to allow
pero - ale - but
perro - pies - dog
persona - osoba - person
personaje - postać, osobistość - person
personal - osobisty - personal
pertenecer - należeć - to belong to
pesar - ważyć, ciążyć - to weigh
ser pesado - być uciążliwym, natrętnym - be obtrusive
peso - waga, nazwa waluty - weight
pie - stopa - foot
a pie - pieszo - afoot
piedra - kamień, skała - stone
piel - skóra, futro, skórka - skin
pierna - noga - leg
piso - mieszkanie, piętro - floor
placer - przyjemność - to please
plaza - miejsce, plac - seat, square
pleno - pełny, napełniony - full, complete
población - ludność, populacja - population
pobre - biedny - poor
poco/a - mało - little, few
poder - móc, władza - to be able to, can, might, may
policía - policja, policjant(ka) - police
política - polityka - politics
político - polityczny, polityk - political
poner - kłaść - to put
por ejemplo - na przykład - for example
por - przez, po, w - by, for, per
¿por qué? - dlaczego? - why?
porque - ponieważ, dlatego że - because, why
poseer - posiadać - to posses, own
posibilidad - możliwość - possibility
posible - możliwy - posible
posición - pozycja - position
práctico - praktyczny - practical
precio - cena - price, cost
preciso/a - dokładny, potrzebny - precise
preferir - woleć, preferować - to prefer
pregunta - pytanie - a question
preguntar - pytać - to ask
prensa - prasa - press
preocuparse - martwić się - to worry
preparar - przygotować - to prepare
presencia - obecność - presence
presentar - przedstawiać - to present
presente - obecny, teraźniejszy - present
presidente - prezydent, prezes - president
pretender - starać się, pretendować - to try, court
primer(o) - pierwszy - first
principal - główny, podstawowy - principal
principio - początek, zasada - beginning, principle
privar - pozbawić - deprive
probable - możliwy, prawdopodobny - probable
problema - problem - problem
proceso - proces - process
producir - produkować, powodować - to produce
producto - produkt - product
profesional - profesjonalny, zawodowiec - professional
profesor/sora - nauczyciel - teacher
profundo/a - głęboki - deep
programa - program - program
pronto/a - szybko, wcześnie - soon, quick
propio/a - własny - own
proponer - proponować - to propose, nominate
provocar - powodować, prowokować - to cause
próximo/a - następny, kolejny - next
proyecto - projekt - project
prueba - próba, dowód, sprawdzian - test, proof, evidence
publicar - publikować - to publish
público/a - publiczny, publiczność - public
pueblo - wioska, miasteczko - town
puerta - drzwi, brama - door
puesto - stanowisko, stoisko - position, place
punto - punkt, kropka - point
puro/a - czysty (bez domieszek) - pure
que - że, który, co - that
qué - co - what
quedar - (po)zostać, umówić się, pasować (o ubraniu) - to stay
querer - chcieć, kochać - to want
quien - kto, który, która - who
quién - kto? - who
quitar - zabierać, usuwać - to remove, take away
quizá - być może - perhaps, maybe
rápido/a - szybki - rapid, quick
rato - chwila - short while
razón\zones - rozum, powód - reason
real - rzeczywisty, królewski - royal, real
realidad - rzeczywistość - reality
realizar - realizować, wykonać - to make, realize
recibir - otrzymać - to receive
reciente - niedawny, ostatni - recent
recoger - zbierać, posprzątać, odebrać (np. z lotniska) - to gather, pick up
reconocer - rozpoznać, uznać - to recognize
recordar - pamiętać, przypominać - to remember, remind
recorrer - przejechać, przebyć - to cross, travel through
recuerdo - pamięć, wspomnienie, pamiątka - memory, remembrance
recuperar - odzyskać - to recover
recuperarse - wyzdrowieć, wydobrzeć - to recuperate
reducir - redukować, zmniejszać - to reduce
referirse (a) - odnosić się (do) - refer (to)
régimen - dieta, ustrój, reżim - regime
regresar - wracać - to return, come back
reír - śmiać się - to laugh
relación\ciones - relacja, związek - relation
religioso/a - religijny - religious
repetir - powtarzać - to repeat
representar - reprezentować - to represent
resolver - rozwiązywać - to solve
responder - odpowiedzieć - to answer
responsable - odpowiedzialny - responsible
respuesta - odpowiedź - answer
resto - reszta - rest
resultado - rezultat, wynik - result, outcome
resultar - okazać się - to turn out, work out, succeed
reunión\niones - zebranie, spotkanie - meeting
reunir - połączyć, zjednoczyć - to unite, join
revista - czasopismo - magazine
rey - król - king
rico/a - bogaty, smaczny - rich
riesgo - ryzyko - risk
río - rzeka - river
rojo/a - czerwony - red
romper - (z)łamać, (ze)psuć, zerwać (z kimś) - to break
ropa - ubrania, odzież - clothes
saber - wiedzieć, smakować, potrafić - to know
sacar - wyciągać, wyjmować, wyrywać - to remove, take out
sala - sala - room, living room
sala de espera - poczekalnia - waiting room
salida - wyjście, odlot, odjazd - exit, departure
salir - wychodzić - to leave, go out
sangre - krew - blood
secreto/a - tajemnica, sekretny - secret
sector - dział, część - sector
seguir - podążać za, śledzić, naśladować - to follow
según - według - according to
segundo - drugi, sekunda - second
seguridad - bezpieczeństwo, ubezpieczenie - security
seguro/a - pewny, bezpieczny - safe
seis - sześć - six
semana - tydzień - week
semejante - podobny - similar
señalar - pokazywać, zaznaczać, wskazywać - to indicate, point out
señor - pan - sir, man
señora - pani - lady
sensación\ciones - wrażenie, uczucie, sensacja - sensation, feeling
sentarse - siadać - to seat, sit
sentido/a - sens, zmysł - heartfelt, sense
sentimiento - uczucie, poczucie - feeling
sentir - czuć, żałować - to feel
lo siento - przykro mi, przepraszam - sorry
separar - oddzielić, rozłączyć - to separate
ser - być - to be
serie/a - seria, serial - series
serio - poważny - serious
servicio - usługa, obsługa - service
servir - służyć, obsługiwać - to serve
sexo - płeć, seks - sex
sexual - seksualny - sexual
si - jeśli, jeżeli - if, yes
sí - tak - yes
siempre - zawsze - always
siete - siedem - seven
siglo - wiek, stulecie - century
significar - znaczyć - to mean
siguiente - następny, następujący - following, next
silencio - cisza - silence
simple - zwykły, prosty - simple
sin - bez - without
sino (que) - ale, lecz - but
sistema - system - system
sitio - miejsce - place, site
situación\ciones - sytuacja - situation
situar - umiejscowić - to locate
sobre - na, koperta - envelope, on
social - społeczny - social
sociedad - społeczeństwo - society
sol - słońce - sun
solo/a - sam - alone
sólo - tylko - only
solución\ciones - rozwiązanie - solution
sombra - cień - shadow
someter - poddać, uzależnić - to subjugate
sonar - dźwięczeć, dzwonić - to sound
sonreír - uśmiechać się - to smile
sonrisa - uśmiech - smile
sorprender - zaskakiwać - to surprise
sostener - podtrzymywać, utrzymywać - to maintain, support, hold
soy - jestem - I am
su - jego, jej - his
subir - wchodzić (do góry), wjeżdżać, wsiadać (do pojazdu) - to raise
suceder - zdarzać się - to happen/ occur
suelo - podłoga, grunt - ground, floor
sueño - sen, marzenie - dream
suerte - szczęście - luck
mala suerte - pech - bad luck
suficiente - wystarczający, dostateczny - enough
sufrir - cierpieć, doświadczać, znosić - to suffer
superar - przezwyciężać, przewyższać - to surpass
superior - wyższy, zwierzchnik - superior
suponer - przypuszczać - to suppose
surgir - powstać, wynurzyć się, wyłonić się - to arise
suyo/a - jego/jej - his/her/its
tal vez - być może - perhaps
tal - taki, tego rodzaju - so
también - też, także - also, too
tampoco - też nie - neither
tan - tak, tak bardzo - so
tanto/a - tyle, tak bardzo - so much
tarde - późno, popołudnie - late
tarea - praca, zadanie (do wykonania) - homewrok
técnica - technika - technique
técnico/a - techniczny, technik - technician
tema - temat - theme
temer - bać się, obawiać się - to fear
tender - napinać, naciągać - to strech out
tener - mieć - to have
tercer(o) - trzeci - third
terminar - kończyć - to finish
término - termin - term
texto - tekst - text
tiempo - czas, pogoda - time
tierra - ziemia - earth
tía - ciotka; (potocznie) baba, dziewczyna - aunt
tío - wujek; (potocznie) facet, chłopak - uncle
tipo - typ, rodzaj - type
tirar - rzucać, wyrzucać - to throw
título - tytuł - title
tocar - dotykać, grać (na instrumencie) - to touch
todavía - jeszcze - still
todo - wszystko, cały - everything
tomar - brać, pić, jeść - to take, to drink
tomar el sol - opalać się - sunbathe
tono - ton, dźwięk, brzmienie - tone
total - zupełny - total
trabajar - pracować - to work
trabajo - praca - job
traer - przynieść - to bring
tratar de - próbować - to try
tres - trzy - three
tu - ty, twój - you, your
último/a - ostatni - last
único - jedyny - only, unique
unidad - jednostka, połączenie - unit
unir - łączyć, jednoczyć - to unite
uno/una - jeden/jedna - one
usar - używać, korzystać - to use
uso - użycie - use
usted - pan, pani - you
utilizar - używać - to use
vacío/a - pusty - empty
valer - być wartym - to be worth
vale - ok, dobra - okay
vale la pena - warto było, opłacało się - worth it
valor - wartość, odwaga - value
vecino/a - sąsiad, sąsiedni - neighbor
veinte - dwadzieścia - twenty
velocidad - szybkość, prędkość - speed
vender - sprzedać - to sell
venir - przybyć, przyjść, przyjechać - to come
ventana - okno - window
ver - widzieć, zobaczyć - to see
verano - lato - summer
verdad - prawda - truth
verdadero/a - prawdziwy - true
verde - zielony/a - green
vestir - ubierać - to dress
una vez - raz - once
viaje - podróż - travel
vida - życie - life
viejo/a - stary/a - old
viento - wiatr - wind
violencia - przemoc - violence
vista - wzrok, widok - vision
vivir - mieszkać, żyć - to live
vivo/a - żywy/a - alive
voluntad - wola - will
volver - wracać - to return
voz - głos - voice
vuelta - powrót, spacer - return
y - i - and
ya que - jako że - since
ya - już, tak - already
yo - ja - I
zona - strefa - zone