through - przez coś (poprzez) - przez coś (poprzez)
across - przez (na drugą stronę) - przez (na drugą stronę)
down - na dole, w dół - na dole, w dół
below - pod, poniżej - pod, poniżej
downstairs - na dół, na dole (piętro niżej) - na dół, na dole (piętro niżej)
w dół, na dół, na dole - w dół, na dół, na dole
abandon - porzucać, opuszczać - porzucać, opuszczać
open - otwierać, otwarty - otwierać, otwarty
unlock - otworzyć, odblokować - otworzyć, odblokować
absolute - zupełny, całkowity - zupełny, całkowity
grandfather - dziadek - dziadek
finish - kończyć - kończyć
maybe - (być) może - (być) może
action - czyn, czynność, działanie - czyn, czynność, działanie
accept - akceptować, zgadzać się - akceptować, zgadzać się
approach - zbliżać się - zbliżać się
accompany - towarzyszyć - towarzyszyć
attitude - postawa, stanowisko - postawa, stanowisko
activity - zajęcie, aktywność, zadanie - zajęcie, aktywność, zadanie
act - czyn, akt - czyn, akt
present - obecny, aktualny - obecny, aktualny
act - grać (np. w filmie), odgrywać rolę - grać (np. w filmie), odgrywać rolę
go - iść, chodzić - iść, chodzić
come - przyjść, przybyć, pochodzić - przyjść, przybyć, pochodzić
agreement - zgoda, ok - zgoda, ok
ahead - naprzód, proszę wejść - naprzód, proszę wejść
besides - oprócz tego, poza tym - oprócz tego, poza tym
furthermore - ponadto, co więcej - ponadto, co więcej
acquire - uzyskać, nabyć - uzyskać, nabyć
notice - zauważyć, dostrzec - zauważyć, dostrzec
warn - ostrzegać - ostrzegać
affect - dotykać, poruszać - dotykać, poruszać
affirm - potwierdzać, stwierdzać - potwierdzać, stwierdzać
water - woda - woda
there - tam - tam
now - teraz - teraz
air - powietrze - powietrze
to - do - do
reach - osiągać, dosięgać - osiągać, dosięgać
move away - odejść, wyprowadzić się - odejść, wyprowadzić się
remove - usuwać, wyjąć, zdjąć - usuwać, wyjąć, zdjąć
German - Niemiec, niemiecki - Niemiec, niemiecki
something - coś - coś
someone - ktoś - ktoś
some - jakiś, pewien - jakiś, pewien
any - którykolwiek, jakikolwiek - którykolwiek, jakikolwiek
there - tam - tam
soul - dusza - dusza
tall - wysoki (wzrost) - wysoki (wzrost)
high - wysoki, wysoko - wysoki, wysoko
height - wysokość - wysokość
love - kochać - kochać
both - oba, obydwa, oboje - oba, obydwa, oboje
American - Amerykanin, amerykański - Amerykanin, amerykański
friend - kolega, przyjaciel - kolega, przyjaciel
love - miłość - miłość
large - duży, wielki - duży, wielki
wide - szeroki, obszerny - szeroki, obszerny
add - dodawać - dodawać
analysis - analiza - analiza
walk - chodzić, iść - chodzić, iść
animal - zwierzę - zwierzę
year - rok - rok
in front of - przed, wobec, w obecności - przed, wobec, w obecności
previous - poprzedni, wcześniejszy - poprzedni, wcześniejszy
before - przed, wcześniej - przed, wcześniej
ancient - antyczny, starożytny - antyczny, starożytny
old - stary - stary
announce - ogłaszać, reklamować, zapowiadać - ogłaszać, reklamować, zapowiadać
appear - pojawiać się - pojawiać się
hardly - ledwie, zaledwie - ledwie, zaledwie
scarcely - ledwo - ledwo
apply - (za)stosować - (za)stosować
support - wspierać, popierać, wsparcie - wspierać, popierać, wsparcie
lean - oprzeć, schylić się - oprzeć, schylić się
learn - (na)uczyć się - (na)uczyć się
take advantage of - (s)korzystać, wykorzystać - (s)korzystać, wykorzystać
that - tamten - tamten
that - tamto/tamta - tamto/tamta
here - tutaj - tutaj
tree - drzewo - drzewo
weapon - broń - broń
up - do góry, w górę - do góry, w górę
art - sztuka - sztuka
assure - zapewniać, ubezpieczać - zapewniać, ubezpieczać
as well - też, także - też, także
as well as - jak i - jak i
so - więc, czyli - więc, czyli
therefore - zatem, dlatego - zatem, dlatego
like this - w ten sposób - w ten sposób
aspect - wygląd, aspekt - wygląd, aspekt
matter - sprawa, kwestia; mieć znaczenie - sprawa, kwestia; mieć znaczenie
bussiness - sprawa, biznes, interes - sprawa, biznes, interes
attention - uwaga, wzgląd - uwaga, wzgląd
back - tylny, z powrotem, do tyłu - tylny, z powrotem, do tyłu
behind - za, w tyle - za, w tyle
dare - ośmielić się, pozwolić sobie - ośmielić się, pozwolić sobie
increase - zwiększać, wzrastać - zwiększać, wzrastać
raise - podnieść, podwyżka - podnieść, podwyżka
still - jeszcze - jeszcze
though - chociaż, mimo że - chociaż, mimo że
authentic - prawdziwy, autentyczny - prawdziwy, autentyczny
author - autor, twórca - autor, twórca
authority - władze, autorytet - władze, autorytet
advance - iść naprzód, robić postępy - iść naprzód, robić postępy
yesterday - wczoraj - wczoraj
aid - pomoc - pomoc
help - pomagać, pomoc - pomagać, pomoc
blue - niebieski - niebieski
lower - zmniejszyć, ściszać, opuszczać - zmniejszyć, ściszać, opuszczać
go down - schodzić, zjeżdżać - schodzić, zjeżdżać
low - niski, nisko  - niski, nisko
short - krótki, niski (osoba) - krótki, niski (osoba)
faint - słaby, zasłabnąć - słaby, zasłabnąć
neighborhood - dzielnica, osiedle - dzielnica, osiedle
base - podstawa, baza - podstawa, baza
fairly - uczciwie, całkiem, dość - uczciwie, całkiem, dość
rather - dosyć, raczej, zamiast - dosyć, raczej, zamiast
drink - napój; pić - napój; pić
well - dobrze, starannie - dobrze, starannie
good - dobry - dobry
white - biały - biały
mouth - usta - usta
all right - w porządku - w porządku
arm - ramię, ręka - ramię, ręka
look for - poszukiwać, szukać - poszukiwać, szukać
seek - szukać - szukać
horse - koń - koń
head - głowa - głowa
end - koniec, kończyć - koniec, kończyć
carry out - doprowadzić do końca, skończyć - doprowadzić do końca, skończyć
each - każdy, każda - każdy, każda
chain - łańcuch, kanał telewizyjny - łańcuch, kanał telewizyjny
fall - upadek; upaść, spaść - upaść, spaść
street - ulica - ulica
bed - łóżko - łóżko
change - zmiana, wymiana; zmieniać, wymieniać - zmiana, wymiana; zmieniać, wymieniać
road - droga - droga
countryside - kampania - kampania
field - wieś, pole, boisko - wieś, pole, boisko
sing - śpiewać - śpiewać
quantity - ilość - ilość
capacity - zdolność, pojemność - zdolność, pojemność
able - zdolny (do czegoś) - zdolny (do czegoś)
capital - stolica - stolica
face - twarz - twarz
character - charakter - charakter
meat - mięso - mięso
running - wyścig, kariera, kierunek studiów - wyścig, kariera, kierunek studiów
letter - list - list
house - dom, mieszkanie - dom, mieszkanie
married - żonaty/mężatka - żonaty/mężatka
marry - pobrać się - pobrać się
almost - prawie - prawie
case - przypadek - przypadek
reason - przyczyna (dlaczego ktoś coś robi) - przyczyna (dlaczego ktoś coś robi)
cause - przyczyna (która powoduje, że coś się wydarzy) - przyczyna (która powoduje, że coś się wydarzy)
celebrate - świętować, obchodzić - świętować, obchodzić
mobile - telefon komórkowy - telefon komórkowy
central - centralny, główny - centralny, główny
downtown - centrum miasta - centrum miasta
center - centrum, środek, nadzienie - centrum, środek, nadzienie
brain - mózg - mózg
close - zamykać - zamykać
girl - dziewczyna - dziewczyna
boy - chłopak - chłopak
sky - niebo - niebo
heaven - niebo, raj - niebo, raj
science - nauka - nauka
scientific - naukowy, naukowiec - naukowy, naukowiec
hundred - sto - sto
certain - pewny, pewien - pewny, pewien
five - pięć - pięć
cinema - kino - kino
circumstance - okoliczność - okoliczność
city - miasto - miasto
citizen - obywatel - obywatel
civil - cywilny - cywilny
clearly - jasno, wyraźnie - jasno, wyraźnie
clear - jasny, wyraźny, oczywisty - jasny, wyraźny, oczywisty
class - klasa, lekcja - klasa, lekcja
car - samochód - samochód
take - wziąć, brać - wziąć, brać
take the subway/taxi - wsiąść do metra/taksówki (wziąć taksówkę) - wsiąść do metra/taksówki (wziąć taksówkę)
put - umieścić, ułożyć, włożyć - umieścić, ułożyć, włożyć
color - kolor - kolor
comment - komentować, komentarz - komentować, komentarz
discuss - omówić, dyskutować - omówić, dyskutować
mention - wzmianka, wspomnieć - wzmianka, wspomnieć
begin - zaczynać - zaczynać
start - zabrać się (do czegoś), zacząć - start
eat - jeść - jeść
how - jak, jaki, jaka - jak, jaki, jaka
companion - towarzysz - towarzysz
company - kompania, towarzystwo - kompania, towarzystwo
complete - zupełny, całkowity, dokończyć - zupełny, całkowity, dokończyć
full - pełny, napełniony, syty - pełny, napełniony, syty
buy - kupić - kupić
purchase - nabyć, kupić - nabyć, kupić
understand - rozumieć - rozumieć
common - wspólny, powszechny, zwykły - wspólny, powszechny, zwykły
communication - komunikacja, łączność - komunikacja, łączność
with - z - z
concept - pojęcie, myśl, koncept - pojęcie, myśl, koncept
conscience - świadomość, sumienie - świadomość, sumienie
specific - konkretny, określony - konkretny, określony
concrete - beton; konkretny, namacalny
condition - warunek, stan, sytuacja - warunek, stan, sytuacja
drive - prowadzić (pojazd) - prowadzić (pojazd)
outfit - kostium, strój, zestaw - kostium, strój, zestaw
band - pasmo, opaska, pasek - pasmo, opaska, pasek
joint - wspólny, połączony; połączenie, złącze - wspólny, połączony; połączenie, złącze
know - wiedzieć, znać - wiedzieć, znać
meet - spotkać, poznać się - spotkać, poznać się
knowledge - wiedza, znajomość - wiedza, znajomość
consequence - konsekwencja, skutek - konsekwencja, skutek
conserve - zachowywać, konserwować - zachowywać, konserwować
consider - rozważać, uważać (za coś, za kogoś) - rozważać, uważać (za coś, za kogoś)
consist (of) - polegać (na czymś) - polegać (na czymś)
constant - stały, niezmienny - stały, niezmienny
constitute - stanowić, tworzyć - stanowić, tworzyć
build - budować, tworzyć - budować, tworzyć
construct - wytwór; konstruować, budować - wytwór; konstruować, budować
contact - kontakt - kontakt
count - liczyć, liczba - liczyć, liczba
contemplate - kontemplować - kontemplować
contain - zawierać - zawierać
answer - odpowiedź; odpowiadać - odpowiedź; odpowiadać
continue - kontynuować - kontynuować
against - przeciw - przeciw
opposite - przeciwny - przeciwny
control - kontola, sterowanie, władza; nadzorować - kontola, sterowanie, władza; nadzorować
check - sprawdzać, kontrolować; kontrola, badanie - kontrola, badanie; sprawdzać, kontrolować
convince - przekonać - przekonać
conversation - rozmowa - rozmowa
convert - przemieniać, nawracać - przemieniać, nawracać
turn into - przekształcać - przekształcać
heart - serce - serce
run - biec, biegać, działać - biegać
race - wyścig, rywalizować
current - zwykły, bieżący, prąd - zwykły, bieżący, prąd
cut - ciąć, obcinać, kroić - ciąć, obcinać, kroić
thing - rzecz - rzecz
habit - zwyczaj, nawyk - zwyczaj, nawyk
create - tworzyć - tworzyć
grow - rosnąć (wartość, jakość), hodować - rosnąć (wartość, jakość), hodować
increase - zwiększyć; wzrost, przyrost - zwiększyć; wzrost, przyrost
believe - wierzyć - wierzyć
crisis - kryzys - kryzys
cross - przechodzić (przez), krzyżować - przechodzić (przez), krzyżować
square - kwadrat, kwadratowy, druga potęga - kwadrat, kwadratowy, druga potęga
picture - obraz, obrazek, zdjęcie - obraz, obrazek, zdjęcie
painting - malowidło, malarstwo - malowidło, malarstwo
which? - który? - który?
what? - co?, jaki? - co?, jaki?
any - każdy, jakikolwiek - każdy, jakikolwiek
when - kiedy - kiedy
how much/many? - ile? - ile?
four - cztery - cztery
fourth - czwarty, ćwierć - czwarty, ćwierć
quarter - ćwierć, dzielnica, kwartał - ćwierć, dzielnica, kwartał
cover - osłona; zakrywać, pokrywać - osłona; zakrywać, pokrywać
count - rachunek, konto - rachunek, konto
body - ciało - ciało
affair - sprawa, rzecz, afera - sprawa, rzecz, afera
culture - kultura - kultura
cultural - kulturalny, kulturowy - kulturalny, kulturowy
accomplish - osiągnąć, wykonać - osiągnąć, wykonać
whose? - czyj? - czyj?
give - dawać - dawać
data - dane - dane
owe - być winnym, zawdzięczać - być winnym, zawdzięczać
decide - decydować - decydować
say - powiedzieć, mówić - powiedzieć, mówić
tell - mówić, opowiadać, relacjonować - mówić, opowiadać, relacjonować
decision - decyzja - decyzja
declare - deklarować - deklarować
dedicate - dedykować, przeznaczać - dedykować, przeznaczać
finger - palec - palec
toe - palec (u nogi) - palec (u nogi)
defend - bronić - bronić
defense - obrona - obrona
define - definiować, określać, ustalać - definiować, określać, ustalać
definitive - ostateczny, definitywny - ostateczny, definitywny
leave - odejść, opuścić, zostawić - odejść, opuścić, zostawić
rest of the - pozostali, reszta - pozostali, reszta
too much - zbyt dużo, zbyt, za bardzo - zbyt dużo, zbyt, za bardzo
demonstrate - okazać, dowieść - okazać, dowieść
within, in - w, wewnątrz, w granicach - w, wewnątrz, w granicach
depend - zależeć - zależeć
right - prawy, właściwy - prawa, prawica
disappear - zniknąć - zniknąć
develop - rozwijać - rozwijać
development - rozwój - rozwój
discover - odkryć - odkryć
since - od kiedy - od kiedy
wish - życzyć, pragnąć, pożądać - życzyć, pragnąć, pożądać
desire - życzenie, pragnienie - życzenie, pragnienie
wake up - budzić - budzić
after - po - po
afterwards - potem, później - potem
then - wtedy, następnie - wtedy, następnie
destiny - przeznaczenie, los - przeznaczenie, los
stop - przerwa, przystanek; przestać, zatrzymać - przerwa, przystanek; przestać, zatrzymać
determine - określić, ustalić - określić, ustalić
behind - za, z tyłu - za, z tyłu
day - dzień - dzień
newspaper - codzienny, dziennik - codzienny, dziennik
ten - dziesięć - dziesięć
difference - różnica - różnica
different - inny, różny - inny, różny
difficult - trudny - trudny
difficulty - trudność - trudność
money - pieniądze - pieniądze
God - Bóg - Bóg
address - adres - adres
direction - kierunek, kierowanie - kierunek, kierowanie
direct - bezpośredni; nakierować - bezpośredni; nakierować
straight - prosty, rzetelny, prosto - prosty, rzetelny, prosto
director - dyrektor, reżyser - dyrektor, reżyser
manager - kierownik - kierownik
arrange - organizować, planować, układać - organizować, planować, układać
distance - dystans, odległość - dystans, odległość
different - odmienny - odmienny
diverse - różny, rozmaity - różny, rozmaity
double - podwójny - podwójny
doctor - doktor - doktor
pain - ból - ból
where - gdzie - gdzie
where? - gdzie? - gdzie?
Sunday - niedziela - niedziela
sleep - spać - spać
two - dwa - dwa
doubt - wątpliwość - wątpliwość
during - podczas - podczas
hard - twardy, ciężki, trudny - twardy, ciężki, trudny
miss - tęsknić - tęsknić
economical - oszczędny, ekonomiczny - oszczędny, ekonomiczny
age - wiek - wiek
effect - skutek, efekt - skutek, efekt
example - przykład - przykład
he - on - on
him - jego - jego
choice - wybór, możliwość - wybór, możliwość
election - wybór, wybory
select - wybrać, wybrany - wybrać, wybrany
choose - wybrać - wybrać
element - element, pierwiastek, żywioł - element, pierwiastek, żywioł
elevate - awansować, podnieść znaczenie - awansować, podnieść znaczenie
company - firma, przedsiębiorstwo - firma, przedsiębiorstwo
into - do (środka) - do (środka)
inside - wewnątrz, wnętrze - wewnątrz, wnętrze
turn on - włączyć - włączyć
set fire to - podpalać - podpalać
on top - na (powierzchni) - na (powierzchni)
find - znaleźć - znaleźć
energy - energia - energia
illness - choroba (ogólnie, bez konkretnej diagnozy) - choroba (ogólnie, bez konkretnej diagnozy)
disease - choroba (zdiagnozowana) - choroba (zdiagnozowana)
sickness - choroba; mdłości, nudności - choroba; mdłości, nudności
ill/sick - chory - chory
enormous - ogromny - ogromny
teach - uczyć (kogoś) - uczyć (kogoś)
understand - rozumieć - rozumieć
find out - dowiedzieć się, odkryć - dowiedzieć się, odkryć
inform - informować, donosić - informować, donosić
then - więc, zatem, wtedy - więc, zatem, wtedy
entrance - wejście, wjazd - wejście, wjazd
entry - wejście, wjazd, wpis, hasło (słownik) - wejście, wjazd, wpis, hasło (słownik)
enter - wchodzić, wprowadzić (dane) - wchodzić, wprowadzić (dane)
between - między - między
among - pomiędzy, wśród
deliver - dostarczyć, rodzić, zadać (np. cios) - dostarczyć, rodzić, zadać (np. cios)
send - wysłać, posłać - wysłać, posłać
epoch, period - epoka - epoka
period - okres, faza, termin - okres, faza, termin
equipment - wyposażenie - wyposażenie
team - zespół, drużyna - zespół, drużyna
error - błąd - błąd
mistake - pomyłka - pomyłka
that is to say - to znaczy - to znaczy
escape - uciec, ulotnić się - uciec, ulotnić się
run away - uciekać
write - pisać - pisać
writer - pisarz - pisarz
listen - słuchać - słuchać
heard - słyszany - słyszany
that - ten/ta - ten/ta
effort - wysiłek, trud - wysiłek, trud
that - to - to
space - przestrzeń, kosmos - przestrzeń, kosmos
back - plecy - plecy
Spain - Hiszpania - Hiszpania
spanish - hiszpański, Hiszpan - hiszpański, Hiszpan
special - specjalny - specjalny
species - gatunek, rodzaj - gatunek, rodzaj
hope - nadzieja, mieć nadzieję - nadzieja, mieć nadzieję
prospect - perspektywa - perspektywa
wait - czekać - czekać
spirit - duch - duch
is - jest, znajduje się - jest, znajduje się
establish - ustanowić - ustanowić
state - stan, państwo - stan, państwo
United States - Stany Zjednoczone - Stany Zjednoczone
be - być - być
this - ten, ta, to - ten, ta, to
I am - jestem - jestem
star - gwiazda - gwiazda
structure - budowa, struktura - budowa, struktura
study - studiować, uczyć się; badanie - studiować, uczyć się; badanie
studies - studia - studia
stage - etap - etap
Europe - Europa - Europa
European - europejski - europejski
evident - oczywisty - oczywisty
avoid - unikać - unikać
exact - dokładny precyzyjny - dokładny precyzyjny
demand - żądać, wymagać - żądać, wymagać
existence - istnienie, egzystencja, byt - istnienie, egzystencja, byt
exist - istnieć - istnieć
success - sukces - sukces
experience - doświadczenie - doświadczenie
explain - tłumaczyć - tłumaczyć
expression - wyrażenie - wyrażenie
extend - rozpowszechniać, rozprzestrzeniać - rozpowszechniać, rozprzestrzeniać
outside - na dworze, na zewnątrz - na dworze, na zewnątrz
foreigner - cudzoziemiec, obcokrajowiec - cudzoziemiec, obcokrajowiec
foreign - zagraniczny, obcy - zagraniczny, obcy
strange - dziwny, nieznany, nieznajomy - dziwny, nieznany, nieznajomy
extreme - skrajny, skrajność - skrajny, skrajność
easy - łatwy - łatwy
lack - brak, niedobór; brakować - brak, niedobór; brakować
family - rodzina - rodzina
familial - rodzinny, dziedziczny - rodzinny, dziedziczny
famous - sławny, słynny - sławny, słynny
phenomenon - zjawisko, fenomen - zjawisko, fenomen
celebration - 	uroczystość, święto, świętowanie - 	uroczystość, święto, świętowanie
party - impreza, partia - impreza, partia
figure - cyfra, liczba, figura, sylwetka - cyfra, liczba, figura, sylwetka
shape - forma, kształt; formować - forma, kształt; formować
imagine - wyobrażać sobie - wyobrażać sobie
affix - przymocować - przymocować
final - końcowy, ostateczny, finał - końcowy, ostateczny, finał
physical - fizyczny - fizyczny
physicist - fizyk - fizyk
flower - kwiat - kwiat
bottom - dno, dół (czegoś), spód - dno, dół (czegoś), spód
shape - kształt, sposób - kształt, sposób
form - forma, postać; uformować, kształtować - forma, postać; uformować, kształtować
french - francuski, Francuz - francuski, Francuz
France - Francja - Francja
phrase - zdanie - zdanie
frequency - częstotliwość - częstotliwość
in front - czoło, przód - czoło, przód
cold - zimno, zimny, przeziębienie - zimno, zimny, przeziębienie
cool - chłodny; świetny
fire - ogień - ogień
source - źródło - źródło
beyond - poza - poza
strong - silny, mocny - silny, mocny
strength - siła, wytrzymałość, mocna strona - siła, wytrzymałość, mocna strona
force - siła; zmusić, narzucać - siła; zmusić, narzucać
function - funkcja, funkcjonować - funkcja, funkcjonować
fundamental - podstawowy - podstawowy
football/soccer - piłka nożna - piłka nożna
future - przyszłość - przyszłość
win - wygrana, zwycięstwo; wygrywać - wygrana, zwycięstwo; wygrywać
general - ogólny - ogólny
people - ludzie - ludzie
gesture - gest, mina - gest, mina
government - rząd - rząd
blow - wiać; powiew - wiać; powiew
grace - łaska - łaska
thanks - dziękuję - dziękuję
big - duży, wielki - duży, wielki
great - wielki; wspaniały, fantastyczny - wielki; wspaniały, fantastyczny
grave - poważny; grób - poważny; grób
shout - krzyk, krzyczeć - krzyk, krzyczeć
scream - wrzeszczeć - wrzeszczeć
group - grupa, pogrupować - grupa, pogrupować
keep - trzymać, zachować, przechowywać - trzymać, zachować, przechowywać
war - wojna - wojna
like - podobać się, lubić - podobać się, lubić
taste - smak, gust; smakować, spróbować - smak, gust; smakować, spróbować
pleasure - przyjemność, rozkosz - przyjemność, rozkosz
liking - sympatia, upodobanie - sympatia, upodobanie
room - pokój, pomieszczenie, miejsce - pokój, pomieszczenie
bedroom - sypialnia - sypialnia
habitual - zwyczajowy - zwyczajowy
usual - zwykły - zwykły
speak - mówić, rozmawiać (często oficjalnie) - mówić, rozmawiać (często oficjalnie)
talk - mówić, rozmawiać (nieoficjalnie), rozmowa - mówić, rozmawiać (nieoficjalnie), rozmowa
do - robić, uprawiać, spowodować - robić, uprawiać, spowodować
make - robić, uczynić, produkować - robić, uczynić, produkować
to do - do zrobienia - do zrobienia
towards - w kierunku, do - w kierunku, do
until - aż do, dopóki nie - aż do, dopóki nie
even - nawet; parzysty - nawet; parzysty
odd - dziwny; nieparzysty - dziwny; nieparzysty
fact - fakt, załatwione, zrobione - fakt, załatwione, zrobione
sister - siostra - siostra
brother - brat - brat
beautiful - piękny - piękny
daughter - córka - córka
son - syn - syn
history - historia - historia
historical - historyczny - historyczny
man - człowiek, mężczyzna - człowiek, mężczyzna
shoulder - ramię, bark - ramię, bark
hour - godzina - godzina
today - dzisiaj - dzisiaj
human - ludzki, człowiek - ludzki, człowiek
idea - pomysł - pomysł
church - kościół - kościół
equal - taki sam, jednakowy - taki sam, jednakowy
image - wizerunek, obraz, zdjęcie - wizerunek, obraz, zdjęcie
prevent - uniemożliwić - uniemożliwić
impose - nałożyć, narzucić - nałożyć, narzucić
importance - ważność, znaczenie - ważność, znaczenie
important - ważny - ważny
impossible - niemożliwy - niemożliwy
include - włączyć, przyłączyć - włączyć, przyłączyć
in fact - faktycznie - faktycznie
indicate - wskazywać, sugerować - wskazywać, sugerować
individual - osobnik, jednostka - osobnik, jednostka
information - informacja - informacja
English - angielski, Anglik - angielski, Anglik
initiate - inicjować, zaczynać - inicjować, zaczynać
immediate - natychmiastowy - natychmiastowy
insist - nalegać - nalegać
instant - chwila; natychmiastowy - chwila; natychmiastowy
interest - zainteresowanie; interesować - zainteresowanie; interesować
interior - wewnętrzny; wnętrze - wewnętrzny; wnętrze
international - międzynarodowy - międzynarodowy
insert - włożyć, wsunąć, wsadzić - włożyć, wsunąć, wsadzić
introduce - wprowadzić, przedstawić się/kogoś - wprowadzić, przedstawić się/kogoś
left - lewa, lewica - lewa, lewica
never - nigdy - nigdy
boss - szef - szef
leader - przywódca - przywódca
chief - główny; wódz, naczelnik, szef - główny; wódz, naczelnik, szef
young person - młody, młodzieniec - młody, młodzieniec
game - gra, mecz, rozgrywka - gra, mecz, rozgrywka
player - gracz; odtwarzacz - gracz; odtwarzacz
gambler - hazardzista - hazardzista
play - bawić się, grać; gra - bawić się, grać; gra
gambling - hazard, zakłady - hazard, zakłady
hazard - zagrożenie - zagrożenie
judgment - opinia, wyrok - opinia, wyrok
court - sąd; kort; dwór - sąd; kort; dwór
together - razem - razem, blisko, obok
near - bliski, blisko - bliski, blisko
just - właśnie, akurat, tylko - właśnie, akurat, tylko
fair - sprawiedliwy, uczciwy - sprawiedliwy, uczciwy
lip - warga - warga
side - strona, bok - strona, bok
long - długi - długi
reader - czytelnik - czytelnik
read - czytać - czytać
tongue - język - język
language - mowa, język - mowa, język
slow - wolny - wolny
lift - podnosić; winda, dźwig - podnosić; winda, dźwig
stand up - wstać, podnieść się - wstać, podnieść się
get up - wstawać, budzić - wstawać, budzić
law - prawo - prawo
freedom - wolność - wolność
free - wolny - wolny
book - książka - książka
limit - granica, limit; ograniczać - granica, limit; ograniczać
line - linia - linia
ready - przygotowany, gotowy - przygotowany, gotowy
clever - inteligentny, zdolny, mądry - inteligentny, zdolny, mądry
literature -  literatura -  literatura
call - wołać, nazywać, zadzwonić - wołać, nazywać, zadzwonić
knock - pukanie; pukać, uderzać - pukanie; pukać, uderzać
be called - nazywać się - nazywać się
arrive - przybyć, dotrzeć - przybyć, dotrzeć
fill - napełniać - napełniać
carry - nieść, nosić, mieć na sobie - nieść, nosić, mieć na sobie
cry - płacz, płakać - płacz, płakać
crazy - szalony (o sytuacjach) - szalony
insane - szalony (o ludziach) - szalony
obtain - zyskać, uzyskać - zyskać, uzyskać
achieve - osiągnąć - osiągnąć
fight - walka, kłótnia, walczyć - walka, kłótnia, walczyć
struggle - starać się, usiłować, walczyć - starać się, usiłować, walczyć
later - później - później
place - miejsce, umieszczać, nakładać - miejsce, umieszczać, nakładać
Monday - poniedziałek - poniedziałek
light - światło; jasny; zapalić - światło; jasny; zapalić
lighting - oświetlenie - oświetlenie
mother - matka - matka
poorly - słabo, biednie, źle
incorrectly - błędnie, źle - błędnie, źle
badly - źle, kiepsko - źle, kiepsko
bad - zły, chory - zły, chory
tomorrow - jutro, rano - jutro, rano
command - komenda, rozkaz, dowództwo; rozkazywać - komenda, rozkaz, dowództwo; rozkazywać
way - sposób, droga - sposób, droga
declare - deklarować, ogłosić, wyznać - deklarować, ogłosić, wyznać
hand - dłoń, ręka - dłoń, ręka
maintain - utrzymywać - utrzymywać
machine - maszyna, urządzenie - maszyna, urządzenie
sea - morze - morze
mark - znak, ślad, ocena; oznaczyć, ocenić - znak, ślad, ocena; oznaczyć, ocenić
march - marsz, funkcjonowanie - marsz, funkcjonowanie
march - marsz; maszerować - marsz; maszerować
husband - mąż - mąż
but - lecz - lecz
more - więcej, bardziej, plus - więcej, bardziej, plus
more or less - mniej więcej - mniej więcej
mass - masa, surowe ciasto - masa, surowe ciasto
kill - zabić - zabić
material - materiał, surowiec - materiał, surowiec
maximum - maksymalny - maksymalny
greater - starszy, większy - starszy, większy
majority - większość - większość
means - średni - średni
by means of - poprzez, za  pomocą - poprzez, za  pomocą
doctor - lekarz - lekarz
measurement - miara - miara
in the middle - w środku - w środku
environment - środowisko - środowisko
better - lepszy, lepiej - lepszy, lepiej
memory - pamięć - pamięć
minor - młodszy, nieletni, mniejszy - młodszy, nieletni, mniejszy
less - mniej, minus - mniej, minus
at least - przynajmniej - przynajmniej
message - wiadomość, SMS - wiadomość, SMS
mental - umysłowy, psychiczny - umysłowy, psychiczny
mind - umysł - umysł
often - często - często
market - rynek, targ - rynek, targ
deserve - zasługiwać, być wartym - zasługiwać, być wartym
month -  miesiąc -  miesiąc
it pulls - stół - stół
method - metoda, sposób - metoda, sposób
meter - metr, metro - metr, metro
my - mój, moja - mój, moja
me - mnie, mi - mnie, mi
fear - strach - strach
member - członek - członek
while - natomiast, podczas gdy - natomiast, podczas gdy
thousand - tysiąc - tysiąc
military man - wojskowy - wojskowy
million - milion - milion
minimum - minimalny - minimalny
minister - minister - minister
minute - minuta - minuta
mine - mój - mój
watched - spojrzenie - spojrzenie
watch - zegarek, straż, warta; oglądać, obserwować - zegarek, straż, warta; oglądać, obserwować
same - to samo - to samo
half - połowa - połowa
model - model, modelka, wzorzec - model, modelka, wzorzec
modern - nowoczesny - nowoczesny
mode - sposób, tryb, stan - sposób, tryb, stan
moment - moment, chwila - moment, chwila
moral - moralny, morale - moralny, morale
die - umierać - umierać
show - widowisko; pokazywać, okazywać - widowisko; pokazywać, okazywać
reason - motyw, powód - motyw, powód
move - ruch, krok; poruszyć, przesunąć, przenosić - ruch, krok; poruszyć, przesunąć, przenosić
movement - ruch, poruszanie się - ruch, poruszanie się
motion - ruch, gest - ruch, projekt
much - dużo - dużo
death - śmierć - śmierć
woman - kobieta - kobieta
worldwide - światowy, mundial - światowy, mundial
world - świat - świat
music - muzyka - muzyka
very - bardzo - bardzo
highly - wysoko - wysoko
to be born - urodzić się - urodzić się
national - narodowy, państwowy - narodowy, państwowy
nothing - nic - nic
nobody - nikt - nikt
natural - naturalny - naturalny
nature - przyroda, natura - przyroda, natura
necessary - potrzebny - potrzebny
necessity - konieczność, potrzeba - konieczność, potrzeba
need - potzeba, potrzebować - potzeba, potrzebować
deny - przeczyć, odmawiać - przeczyć, odmawiać
business - interes, biznes - interes, biznes
black - czarny, Murzyn - czarny, Murzyn
not even - nawet nie, ani - nawet nie, ani
nor - też nie - też nie
neither - żaden - żaden, też nie
neither... nor... - ani... ani... - ani... ani...
child - dziecko - dziecko
girl - dziewczynka - dziewczynka
none - żaden - żaden
level - poziom - poziom
no - nie - nie
night - wieczór, noc - wieczór, noc
name - imię - imię
the news - wiadomość, nowina - wiadomość, nowina
novel - powieść - powieść
ours - nasz - nasz
new - nowy - nowy
number - liczba, numer - liczba, numer
never - nigdy - nigdy
or - albo, lub - albo, lub
objective - obiektywny, cel - obiektywny, cel
object - przedmiot - przedmiot
oblige - wyświadczyć przysługę, zobowiązywać - wyświadczyć przysługę, zobowiązywać
required - obowiązkowy - obowiązkowy
work - pracować, działać; praca, dzieło - pracować, działać; praca, dzieło
observe - obserwować - obserwować
get - zyskać, dostać, otrzymać - zyskać, dostać, otrzymać
chance - okazja - okazja
eight - osiem - osiem
occupy - zajmować, okupować - zajmować, okupować
take care - zajmować się - zajmować się
happen - wydarzyć się, stać się - wydarzyć się, stać się
official - oficjalny, urzędowy - oficjalny, urzędowy
offer - oferta; oferować, proponować - oferta; oferować, proponować
hear - słyszeć - słyszeć
eye - oko - oko
forget - zapomnieć - zapomnieć
operation - operacja - operacja
opinion - opinia - opinia
origin - pochodzenie, początek - pochodzenie, początek
gold - złoto - złoto
dark - ciemny, ciemność - ciemny, ciemność
obscure - mało znany - mało znany
another - inny, następny - inny, następny
other - inny, kolejny - inny, kolejny
again - jeszcze raz - jeszcze raz
patient - cierpliwy, pacjent - cierpliwy, pacjent
father - ojciec - ojciec
pay - płacić - płacić
page - strona - strona
country - kraj - kraj
nation - naród - naród
word - słowo - słowo
paper - papier - papier
a pair (of) - para (czegoś) - para (czegoś)
so that - aby - aby
for - dla - dla
towards - do, w kierunku, wobec - do, w kierunku, wobec
seem - wydawać się - wydawać się
wall - ściana - ściana
couple - para, małżeństwo - para, małżeństwo
part - część - część
participate - uczestniczyć - uczestniczyć
particular - konkretny, szczególny - konkretny, szczególny
private - prywatny - prywatny
divide - dzielić, podzielić - dzielić, podzielić
past - przeszłość, miniony, przeszły - przeszłość, miniony, przeszły
pass - podanie, przepustka; zdać, przejść, podać, upłynąć - podanie, przepustka; zdać, przejść, podać, upłynąć
step - krok - krok
peace - pokój, spokój - pokój, spokój
chest - klatka piersiowa, pierś - klatka piersiowa, pierś
request - prośba, wniosek, wniosek; domagać się, aplikować - prośba, wniosek, wniosek; domagać się, aplikować
ask for - prosić o - prosić o
movie - film - film
danger - niebezpieczeństwo - niebezpieczeństwo
dangerous - niebezpieczny - niebezpieczny
hair - włos, włosy, sierść - włos, włosy, sierść
penalty - kara, grzywna - kara, grzywna
though - myśl - myśl
think - myśleć, sądzić - myśleć, sądzić
worse - gorszy - gorszy
little - mały, mało - mały, mało
lose - zgubić, stracić - zgubić, stracić
miss - nie trafić, przegapić, tęsknić - nie trafić, przegapić, tęsknić
perfect - doskonały - doskonały
newspaper - gazeta - gazeta
journalist - dziennikarz - dziennikarz
remain - pozostawać, trwać - pozostawać, trwać
allow - pozwolić - pozwolić
but - ale - ale
dog - pies - pies
person - osoba - osoba
person - postać, osobistość - postać, osobistość
personal - osobisty - osobisty
belong - należeć - należeć
weigh - ważyć, ciążyć - ważyć, ciążyć
be obtrusive - być uciążliwym, natrętnym - być uciążliwym, natrętnym
weight - waga - waga
foot - stopa - stopa
afoot - pieszo - pieszo
stone - kamień, skała - kamień, skała
skin - skóra, futro, skórka - skóra, futro, skórka
leg - noga - noga
floor - mieszkanie, piętro - mieszkanie, piętro
please - proszę!; zadowolić - proszę!; zadowolić
square - plac, rynek - plac, rynek
seat - siedzenie, fotel, miejsce, siedziba; sadzać - siedzenie, fotel, miejsce, siedziba; sadzać
population - ludność, populacja - ludność, populacja
poor - biedny - biedny
few - parę, kilka - parę, kilka
police - policja, policjant(ka) - policja, policjant(ka)
politics - polityka - polityka
political - polityczny, polityk - polityczny, polityk
for example - na przykład - na przykład
why? - dlaczego? - dlaczego?
because - ponieważ, bo - ponieważ, bo
possibility - możliwość - możliwość
posible - możliwy - możliwy
position - położenie, pozycja, stanowisko - położenie, pozycja, stanowisko
practical - praktyczny - praktyczny
price - cena - cena
cost - koszt, kosztować - koszt, kosztować
precise - dokładny, potrzebny - dokładny, potrzebny
prefer - woleć, preferować - woleć, preferować
a question - pytanie - pytanie
ask - pytać - pytać
press - prasa - prasa
to worry - martwić się - martwić się
prepare - przygotować - przygotować
presence - obecność - obecność
present - prezent; obecny, teraźniejszy; wręczać, przedstawiać - prezent; obecny, teraźniejszy; wręczać, przedstawiać
president - prezydent, prezes - prezydent, prezes
first - pierwszy - pierwszy
principal - główny, podstawowy - główny, podstawowy
beginning - początek - początek
principle - zasada - zasada
deprive - pozbawić - pozbawić
probable - możliwy, prawdopodobny - możliwy, prawdopodobny
problem - problem - problem
process - proces - proces
produce - produkować, powodować - produkować, powodować
product - produkt - produkt
professional - profesjonalny, zawodowiec - profesjonalny, zawodowiec
teacher - nauczyciel - nauczyciel
deep - głęboki - głęboki
program - program - program
quick - szybko - szybko
soon - wkrótce, niebawem - wkrótce, niebawem
own - własny, posiadać - własny, posiadać
propose - proponować - proponować
nominate - nominować - nominować
cause - powodować, prowokować - powodować, prowokować
next - następny, kolejny - następny, kolejny
project - projekt - projekt
proof - dowód - dowód
evidence - dowód, zeznanie - dowód
test - próba, sprawdzian, wypróbować - próba, sprawdzian, wypróbować
publish - publikować - publikować
public - publiczny, publiczność - publiczny, publiczność
town - miasteczko - miasteczko
door - drzwi, brama - drzwi, brama
point - punkt, czubek, puenta; wskazać - punkt, czubek, puenta; wskazać
pure - czysty (bez domieszek) - czysty (bez domieszek)
that - że, który, co - że, który, co
stay - (po)zostać, przebywać - (po)zostać, przebywać
want - chcieć - chcieć
who - kto? - kto?
take away - zabierać - zabierać
rapid - szybki, gwałtowny
short while - chwila - chwila
reason - rozum, powód - rozum, powód
real - rzeczywisty, prawdziwy - rzeczywisty, prawdziwy
royal - królewski - królewski
reality - rzeczywistość - rzeczywistość
realize - uświadomić sobie, zrealizować, wdrożyć - uświadomić sobie, zrealizować, wdrożyć
receive - otrzymać - otrzymać
recent - niedawny, ostatni - niedawny, ostatni
pick up - podnieść, odebrać (np. z lotniska) - podnieść, odebrać (np. z lotniska)
gather - gromadzić, zbierać
recognize - rozpoznać, uznać - rozpoznać, uznać
remember - przypomnieć sobie, pamiętać - przypomnieć sobie, pamiętać
remind - przypominać - przypominać
remembrance - wspomnienie, pamiątka - wspomnienie, pamiątka
recover - wyzdrowieć, odzyskać - wyzdrowieć, odzyskać
recuperate - wyzdrowieć, wydobrzeć - wyzdrowieć, wydobrzeć
reduce - redukować, zmniejszać - redukować, zmniejszać
refer (to) - odnosić się (do) - odnosić się (do)
regime - reżim - reżim
come back - wracać - wracać
laugh - śmiać się - śmiać się
relation - relacja, związek - relacja, związek
religious - religijny - religijny
repeat - powtarzać - powtarzać
represent - reprezentować - reprezentować
solve - rozwiązywać - rozwiązywać
responsible - odpowiedzialny - odpowiedzialny
rest - reszta - reszta
result - rezultat, wynik; wynikać (z czegoś) - rezultat, wynik; wynikać (z czegoś)
meeting - zebranie, spotkanie - zebranie, spotkanie
join - dołączyć, przyłączyć się, połączyć - dołączyć, przyłączyć się, połączyć
magazine - czasopismo - czasopismo
king - król - król
rich - bogaty, smaczny - bogaty, smaczny
risk - ryzyko - ryzyko
river - rzeka - rzeka
red - czerwony - czerwony
break - złamać, zepsuć, zerwać (z kimś) - złamać, zepsuć, zerwać (z kimś)
clothes - ubrania, odzież - ubrania, odzież
take out - wyciągać, wyjmować - wyciągać, wyjmować
living room - salon - salon
waiting room - poczekalnia - poczekalnia
exit - wyjazd, wyjście, zjazd - wyjazd, wyjście, zjazd
departure - odejście, odjazd, odlot, wyjazd - odejście, odjazd, odlot, wyjazd
go out - wyjść - wyjść
blood - krew - krew
secret - tajemnica, sekretny - tajemnica, sekretny
sector - dział, część - dział, część
follow - podążać za, śledzić, naśladować - podążać za, śledzić, naśladować
according to - według - według
second - drugi, sekunda - drugi, sekunda
security - bezpieczeństwo, ubezpieczenie - bezpieczeństwo, ubezpieczenie
safe - pewny, bezpieczny - pewny, bezpieczny
six - sześć - sześć
week - tydzień - tydzień
similar - podobny - podobny
indicate - zasugerować, wskazywać - zasugerować, wskazywać
point out - podkreślić, zwrócić uwagę - podkreślić, zwrócić uwagę
sir - pan - pan
lady - pani - pani
sensation - czucie, uczucie, sensacja - czucie, uczucie, sensacja
sit - siadać - siadać
sense - zmysł, wyczucie, uczucie, sens - zmysł, wyczucie, uczucie, sens
feeling - uczucie, poczucie - uczucie, poczucie
feel - czuć - czuć
sorry - przykro mi, przepraszam - przykro mi, przepraszam
separate - oddzielić, rozłączyć - oddzielić, rozłączyć
be - być - być
series - seria, serial - seria, serial
serious - poważny - poważny
service - usługa, obsługa - usługa, obsługa
serve - służyć, obsługiwać - służyć, obsługiwać
sex - płeć, seks - płeć, seks
sexual - seksualny - seksualny
if - gdyby, jeśli, jeżeli, czy (w pytaniu) - gdyby, jeśli, jeżeli, czy (w pytaniu)
yes - tak - tak
always - zawsze - zawsze
seven - siedem - siedem
century - wiek, stulecie - wiek, stulecie
mean - znaczyć, mieć na myśli - znaczyć, mieć na myśli
following - następujący - następujący
silence - cisza - cisza
simple - zwykły, prosty - zwykły, prosty
without - bez - bez
but - ale, lecz - ale, lecz
system - system - system
site - miejsce - miejsce
situation - sytuacja - sytuacja
locate - lokalizować - lokalizować
envelope - koperta - koperta
social - społeczny - społeczny
society - społeczeństwo - społeczeństwo
sun - słońce - słońce
alone - sam - sam
only - tylko - tylko
solution - rozwiązanie - rozwiązanie
shadow - cień - cień
subjugate - poddać, uzależnić - poddać, uzależnić
sound - dźwięk; brzmieć - dźwięk; brzmieć
smile - uśmiech; uśmiechać się - uśmiech; uśmiechać się
surprise - niespodzianka, zaskoczenie; zaskakiwać - niespodzianka, zaskoczenie; zaskakiwać
hold - chwyt; trzymać, zatrzymać - chwyt; trzymać, zatrzymać
I am - jestem - jestem
his - jego, jej - jego, jej
occur - mieć miejsce, wydarzyć się - mieć miejsce, wydarzyć się
ground - ziemia, grunt, pole - ziemia, grunt, pole
floor - podłoga, piętro - podłoga, piętro
dream - sen, marzenie - sen, marzenie
luck - szczęście - szczęście
bad luck - pech - pech
enough - wystarczający, dostateczny - wystarczający, dostateczny
suffer - cierpieć, doświadczać - cierpieć, doświadczać
surpass - przewyższać - przewyższać
superior - wyższy, zwierzchnik - wyższy, zwierzchnik
suppose - przypuszczać - przypuszczać
arise - powstać - powstać
his/her/its - jego/jej - jego/jej
perhaps - być może - być może
also - też, także - też, także
too - też, także, również - też, także, również
neither - też nie - też nie
so much - tyle, tak bardzo - tyle, tak bardzo
late - późno, spóźniony - późno, spóźniony
homewrok - praca, zadanie (do wykonania) - praca, zadanie (do wykonania)
technique - technika - technika
technician - techniczny, technik - techniczny, technik
theme - motyw, temat - motyw, temat
fear - bać się, obawiać się - bać się, obawiać się
stretch out - rozciągać się - rozciągać się
have - mieć - mieć
third - trzeci - trzeci
term - termin - termin
text - tekst - tekst
time - czas, pogoda - czas, pogoda
earth - ziemia - ziemia
aunt - ciotka; (potocznie) baba, dziewczyna - ciotka; (potocznie) baba, dziewczyna
uncle - wujek; (potocznie) facet, chłopak - wujek; (potocznie) facet, chłopak
type - typ, rodzaj - typ, rodzaj
throw - rzucić - rzucić
title - tytuł - tytuł
touch - dotyk; dotykać - dotyk; dotykać
still - jeszcze - jeszcze
everything - wszystko, cały - wszystko, cały
sunbathe - opalać się - opalać się
tone - ton, dźwięk, brzmienie - ton, dźwięk, brzmienie
total - zupełny - zupełny
job - praca - praca
bring - przynieść - przynieść
try - próbować - próbować
three - trzy - trzy
you - ty/wy - ty/wy
your - twój/wasz - twój/wasz
last - ostatni - ostatni
unique - wyjątkowy, unikalny - wyjątkowy, unikalny
unit - jednostka, połączenie - jednostka, połączenie
unite - łączyć, jednoczyć - łączyć, jednoczyć
one - jeden/jedna - jeden/jedna
use - użycie; używać, korzystać - użycie; używać, korzystać
empty - pusty - pusty
be worth - być wartym - być wartym
okay - ok, dobra - ok, dobra
worth it - warto było, opłacało się - warto było, opłacało się
value - wartość, odwaga - wartość, odwaga
neighbor - sąsiad, sąsiedni - sąsiad, sąsiedni
twenty - dwadzieścia - dwadzieścia
speed - szybkość, prędkość - szybkość, prędkość
sell - sprzedać - sprzedać
window - okno - okno
see - widzieć, zobaczyć - widzieć, zobaczyć
summer - lato - lato
truth - prawda - prawda
true - prawdziwy, wierny - prawdziwy, wierny
green - zielony/a - zielony/a
dress - sukienka; ubierać - sukienka; ubierać
once - raz - raz
travel - podróż - podróż
life - życie - życie
old - stary/a - stary/a
wind - wiatr - wiatr
violence - przemoc - przemoc
vision - wzrok, widok - wzrok, widok
live - mieszkać, żyć - mieszkać, żyć
alive - żywy/a - żywy/a
will - wola - wola
voice - głos - głos
return - powrót, zwrot; wracać - powrót, spacer; wracać
and - i - i
since - jako że - jako że
already - już, tak - już, tak
I - ja - ja
zone - strefa - strefa